pckg, tiempo_envio [ns], tiempo_recibido [ns], terminal_envio, terminal_recibido, latencia [ns], profunidad, drivers
05535242,1065,1595,2,5,530,12,10
0195e814,12085,12565,0,1,480,12,10
0297b0d1,23065,23585,1,2,520,12,10
09df78c1,23555,24115,1,9,560,12,10
05de9f98,34015,34445,4,5,430,12,10
07cdb8f3,34385,34805,5,7,420,12,10
00724c68,34105,35165,6,0,1060,12,10
038495c9,34665,35885,8,3,1220,12,10
01a4ec52,34585,36245,9,1,1660,12,10
032d6123,34285,36605,0,3,2320,12,10
00784c53,34125,36965,1,0,2840,12,10
03ff7e57,34175,37325,2,3,3150,12,10
07272778,34185,37685,3,7,3500,12,10
0107ae83,34545,38055,5,1,3510,12,10
06f62634,34845,38425,7,6,3580,12,10
07b582d9,34755,38785,8,7,4030,12,10
063870a5,34925,39145,9,6,4220,12,10
01b22803,34975,39505,0,1,4530,12,10
05069f27,34415,39865,1,5,5450,12,10
08421206,35035,40235,3,8,5200,12,10
059650a5,135005,135385,5,5,380,12,10
00513ae7,135005,135745,7,0,740,12,10
08c4bd97,135005,136105,7,8,1100,12,10
0333ed03,135005,136465,3,3,1460,12,10
089e7396,135005,136825,6,8,1820,12,10
02ff29c6,135005,137185,6,2,2180,12,10
038db5a4,135005,137545,4,3,2540,12,10
00fcf0e3,135005,137905,3,0,2900,12,10
07bc4b84,135005,138265,4,7,3260,12,10
08ccc9d3,135005,138625,3,8,3620,12,10
02265b63,135005,138985,3,2,3980,12,10
00a4b156,135005,139345,6,0,4340,12,10
06e37893,135005,139705,3,6,4700,12,10
035007e1,135005,140065,1,3,5060,12,10
09f38866,135005,140425,6,9,5420,12,10
09b36cb9,135005,140785,9,9,5780,12,10
05e8a384,135005,141505,4,5,6500,12,10
05b49ca1,135005,141865,1,5,6860,12,10
05572cf6,135005,142225,6,5,7220,12,10
03530c76,337205,337815,6,3,610,12,10
06cd9287,337095,338175,7,6,1080,12,10
077e4088,337225,338535,8,7,1310,12,10
030042d0,337115,338905,0,3,1790,12,10
097a6fd6,337325,340035,6,9,2710,12,10
007901c1,337475,340465,1,0,2990,12,10
04567865,438025,438505,5,4,480,12,10
09ea7666,438225,438865,6,9,640,12,10
07408da8,438055,439235,8,7,1180,12,10
067c63d9,438135,439595,9,6,1460,12,10
03535247,1085,1495,7,3,410,8,10
044d6091,12115,12545,9,4,430,8,10
0495e818,12055,12915,1,4,860,8,10
04056638,12185,13665,5,4,1480,8,10
07284650,23105,23565,0,7,460,8,10
053e3010,34165,34565,0,5,400,8,10
067cd0d1,34255,34935,2,6,680,8,10
00752122,34095,35295,3,0,1200,8,10
02de9f96,34575,35655,4,2,1080,8,10
09069f20,34835,36375,6,9,1540,8,10
01ff7e52,34775,36735,7,1,1960,8,10
00724c60,34595,37095,8,0,2500,8,10
04457ed8,34435,37815,0,4,3380,8,10
04784c56,34675,38175,1,4,3500,8,10
072d6125,34805,38535,2,7,3730,8,10
0207ae82,34965,38895,3,2,3930,8,10
08421200,35605,39255,4,8,3650,8,10
01726658,35335,39615,5,1,4280,8,10
0262ad52,35995,39975,6,2,3980,8,10
07572cf0,36225,41055,9,7,4830,8,10
0214c3c0,36465,41415,0,2,4950,8,10
0430aca3,36405,41775,1,4,5370,8,10
030f3788,36815,42135,2,3,5320,8,10
02b34d88,36735,42495,3,2,5760,8,10
09e618a3,36555,43215,5,9,6660,8,10
02241850,135005,135385,0,2,380,8,10
05307621,135005,135745,1,5,740,8,10
07bc05b6,135005,136105,6,7,1100,8,10
08ccec25,135005,136465,5,8,1460,8,10
0328f1f4,135005,136825,4,3,1820,8,10
07563583,135005,137185,3,7,2180,8,10
019a82f3,135005,137545,3,1,2540,8,10
01fc1295,135005,137905,5,1,2900,8,10
0340cd03,135005,138265,3,3,3260,8,10
0699bf15,135005,138985,5,6,3980,8,10
084569f5,135005,139345,5,8,4340,8,10
0612f967,135005,139705,7,6,4700,8,10
095816d7,135005,140065,7,9,5060,8,10
012ae3f5,135005,140425,5,1,5420,8,10
00617734,135005,140785,4,0,5780,8,10
0291ae60,135005,141145,0,2,6140,8,10
03119796,135005,141505,6,3,6500,8,10
07f72fd7,135005,141865,7,7,6860,8,10
0579a0b5,135005,142225,5,5,7220,8,10
039e94e5,337085,337465,5,3,380,8,10
041340a8,438045,438545,8,4,500,8,10
07fb9b64,539075,539455,4,7,380,8,10
01f2c046,539515,539985,6,1,470,8,10
00535241,1065,1455,1,0,390,16,2
0095e810,12085,12465,1,0,380,16,2
007cd0d1,12465,13185,1,0,720,16,2
00457ed1,12605,13905,1,0,1300,16,2
00de9f91,23085,23465,1,0,380,16,2
002d6121,23415,23845,1,0,430,16,2
00b582d1,23915,24605,1,0,690,16,2
00726650,34035,34425,1,0,390,16,2
0003e960,34395,35145,1,0,750,16,2
00572cf0,34855,35865,1,0,1010,16,2
0150deb0,35455,36225,0,1,770,16,2
00a12891,35445,36585,1,0,1140,16,2
00a12891,35445,37305,1,0,1860,16,2
01a4b150,135005,135745,0,1,740,16,2
0133ed01,135005,136465,1,1,1460,16,2
01a0c8e0,438165,438685,0,1,520,16,2
00dbc261,438295,439045,1,0,750,16,2
018fdf70,539095,539485,0,1,390,16,2
016adab0,539765,540165,0,1,400,16,2
0090b2a1,539715,540525,1,0,810,16,2
0c535245,1075,1655,5,12,580,1,15
0d95e810,12105,12645,4,13,540,1,15
074d6096,23055,23685,6,7,630,1,15
0b05663e,34055,34605,2,11,550,1,15
06457edc,34535,34975,4,6,440,1,15
033d2aa7,34815,35335,5,3,520,1,15
0e284658,34285,35695,6,14,1410,1,15
0a784c5c,34755,36065,8,10,1310,1,15
0297b0d6,34115,36425,9,2,2310,1,15
03df78c1,34565,37155,12,3,2590,1,15
0af998de,34185,37515,13,10,3330,1,15
06ff7e50,34915,37875,14,6,2960,1,15
09de9f92,34615,38235,0,9,3620,1,15
06457edc,34535,38645,4,6,4110,1,15
033d2aa7,34815,39005,5,3,4190,1,15
0e284658,34285,39365,6,14,5080,1,15
0297b0d6,34115,39755,9,2,5640,1,15
03df78c1,34565,40145,12,3,5580,1,15
0af998de,34185,40505,13,10,6320,1,15
03b22808,135005,135385,8,3,380,1,15
09845aaa,135005,136105,10,9,1100,1,15
04ccc9da,135005,136465,10,4,1460,1,15
0d03e96a,135005,136825,10,13,1820,1,15
033b813b,135005,137185,11,3,2180,1,15
06c380d7,135005,137545,7,6,2540,1,15
0afdd6be,135005,138265,14,10,3260,1,15
078495c4,135005,138625,4,7,3620,1,15
0ce28bd9,135005,138985,9,12,3980,1,15
04b582d7,135005,139345,7,4,4340,1,15
00726650,135005,139705,0,0,4700,1,15
02f6263c,135005,140065,12,2,5060,1,15
0e3870a8,135005,140425,8,14,5420,1,15
0574a02d,337045,337615,13,5,570,1,15
0763eae0,539025,539685,0,7,660,1,15
03535242,1055,1445,2,3,390,15,4
0295e811,12105,12545,3,2,440,15,4
02056632,12275,12905,0,2,630,15,4
023f1760,12625,13265,1,2,640,15,4
024d6090,12195,13985,3,2,1790,15,4
02284650,12425,14345,0,2,1920,15,4
02ff7e52,34105,34505,1,2,400,15,4
01cdb8f1,34265,35235,0,1,970,15,4
02696ce3,34415,35595,1,2,1180,15,4
00069f23,34325,35965,3,0,1640,15,4
0099bf11,135005,135385,1,0,380,15,4
01a4ec53,135005,135745,3,1,740,15,4
00fdd6b0,135005,136105,0,0,1100,15,4
03a12891,135005,136465,1,3,1460,15,4
03b34d80,135005,137545,0,3,2540,15,4
003327e1,135005,137905,1,0,2900,15,4
01bf6d30,337055,337435,0,1,380,15,4
00a595b2,337215,338155,2,0,940,15,4
00f38863,337535,338515,3,0,980,15,4
03caf2a0,337385,338875,0,3,1490,15,4
03ff29c1,337635,339235,1,3,1600,15,4
03bb4a32,337875,339595,2,3,1720,15,4
01617733,337825,339955,3,1,2130,15,4
03b36cb2,438285,438705,2,3,420,15,4
0291ae63,438315,439065,3,2,750,15,4
032e2ed0,438515,439425,0,3,910,15,4
028fdf71,438215,439785,1,2,1570,15,4
03ae2b52,438705,440145,2,3,1440,15,4
01fb6650,438685,440515,0,1,1830,15,4
00e94df2,438765,440885,2,0,2120,15,4
0040cd01,539175,539625,1,0,450,15,4
02535241,1055,1495,1,2,440,15,4
0295e813,12045,12465,3,2,420,15,4
02056630,12185,12825,0,2,640,15,4
02f998d2,12325,13555,3,2,1230,15,4
02457ed0,12755,13915,0,2,1160,15,4
02724c61,12825,14275,1,2,1450,15,4
02de9f92,12775,14995,3,2,2220,15,4
023d2aa0,23105,23485,0,2,380,15,4
013870a1,34415,34865,2,1,450,15,4
03421201,34575,35585,0,3,1010,15,4
00f62633,34405,35945,1,0,1540,15,4
007d6530,34865,36305,2,0,1440,15,4
02845aa3,34625,36665,3,2,2040,15,4
030f3780,35575,37025,0,3,1450,15,4
03265b63,35795,37385,1,3,1590,15,4
02307621,36805,38465,0,2,1660,15,4
03c4bd93,36795,38825,1,3,2030,15,4
03c603b2,36455,39185,2,3,2730,15,4
009a18f2,36915,39545,3,0,2630,15,4
01fb6650,135005,135385,0,1,380,15,4
034569f1,135005,135745,1,3,740,15,4
00eed560,135005,136825,0,0,1820,15,4
012ed3d3,135005,137185,3,1,2180,15,4
015e2763,337065,337495,3,1,430,15,4
02b49ca3,438025,438435,3,2,410,15,4
0072db63,438085,438845,3,0,760,15,4
01807693,539355,539815,3,1,460,15,4
03ebab40,539405,540175,0,3,770,15,4
01535240,1045,1435,0,1,390,6,3
0095e811,12055,12465,1,0,410,6,3
0097b0d0,12175,12825,2,0,650,6,3
00f998d0,12255,13195,1,0,940,6,3
01752120,23055,23445,0,1,390,6,3
023e3010,23085,23835,0,2,750,6,3
017cd0d0,34045,34425,2,1,380,6,3
023f1760,34125,34795,1,2,670,6,3
01de9f90,34405,35155,2,1,750,6,3
02069f22,34795,35875,1,2,1080,6,3
023870a0,135005,135745,0,2,740,6,3
013b8132,135005,136105,2,1,1100,6,3
0030aca2,438195,438585,2,0,390,6,3
028bdf21,438365,438955,1,2,590,6,3
0114c3c2,438275,439315,2,1,1040,6,3
02a12890,539315,539865,0,2,550,6,3
02265b61,539455,540225,1,2,770,6,3
0253524a,1005,1515,10,2,510,16,16
0f284657,12415,12985,0,15,570,16,16
0fde9f93,12895,13355,2,15,460,16,16
0f3e301f,12515,13715,3,15,1200,16,16
0f056637,12175,14075,4,15,1900,16,16
0f95e81d,12085,14445,6,15,2360,16,16
0f3f176e,12645,14835,9,15,2190,16,16
0fdcd3d8,12715,15195,10,15,2480,16,16
0fdf78ce,12825,15605,14,15,2780,16,16
0f457edf,12725,16395,4,15,3670,16,16
0f752122,12435,16765,6,15,4330,16,16
06724c62,23075,23685,2,6,610,16,16
00069f22,23505,24335,2,0,830,16,16
06696ce9,34095,34605,14,6,510,16,16
08a4ec57,34225,34995,1,8,770,16,16
0a3870a3,34565,35355,2,10,790,16,16
0ce28bd6,34325,35715,3,12,1390,16,16
09b582d9,34415,36085,5,9,1670,16,16
03f6263a,34535,36445,6,3,1910,16,16
0807ae8f,34165,36805,7,8,2640,16,16
0e7d653e,35015,37165,8,14,2150,16,16
0172665f,34485,37525,9,1,3040,16,16
04c380df,34995,37885,10,4,2890,16,16
0e265b6b,36075,38245,11,14,2170,16,16
06ccc9d3,34815,38605,12,6,3790,16,16
07d60b71,37295,38965,13,7,1670,16,16
0e421207,34665,39335,15,14,4670,16,16
07845aa5,34765,39695,0,7,4930,16,16
049650a4,35465,40055,1,4,4590,16,16
023b8130,34925,40775,3,2,5850,16,16
08b22806,34605,41495,5,8,6890,16,16
0b513ae0,36245,41855,6,11,5610,16,16
063327e7,36745,42215,7,6,5470,16,16
06c4bd90,36865,42575,8,6,5710,16,16
07d945c9,37425,42945,10,7,5520,16,16
001559fa,37075,43305,11,0,6230,16,16
08e37890,37545,44055,15,8,6510,16,16
0e99bf1e,36835,44415,0,14,7580,16,16
0850deb0,35985,44775,1,8,8790,16,16
0e30762a,36965,45135,2,14,8170,16,16
0a24185c,36555,45525,5,10,8970,16,16
075fb4c5,37005,45885,6,7,8880,16,16
01bc05b7,37515,46605,8,1,9090,16,16
0d7ca59b,135005,135745,11,13,740,16,16
0f0042d9,135005,136105,9,15,1100,16,16
05779faf,135005,136465,15,5,1460,16,16
04d2b798,135005,136825,8,4,1820,16,16
0d0168aa,135005,137185,10,13,2180,16,16
07f41134,135005,137545,4,7,2540,16,16
039a4e4f,135005,137905,15,3,2900,16,16
03e4592f,135005,138265,15,3,3260,16,16
01c225b2,135005,138625,2,1,3620,16,16
0a23a042,135005,138985,2,10,3980,16,16
00f90b94,135005,139345,4,0,4340,16,16
0133ed01,135005,140065,1,1,5060,16,16
0c488781,135005,140425,1,12,5420,16,16
0d90d44c,135005,140785,12,13,5780,16,16
0565d934,135005,141145,4,5,6140,16,16
0918d885,135005,141505,5,9,6500,16,16
03199ba3,135005,141865,3,3,6860,16,16
0ad80db8,135005,142225,8,10,7220,16,16
08c42734,135005,142585,4,8,7580,16,16
074e3c8b,135005,142945,11,7,7940,16,16
0ee5ebda,135005,143305,10,14,8300,16,16
00fb4ae0,135005,143665,0,0,8660,16,16
08fe9533,135005,144025,3,8,9020,16,16
048e4a7e,135005,144745,14,4,9740,16,16
07faa6fe,135005,145105,14,7,10100,16,16
0014ee1d,135005,145465,13,0,10460,16,16
0bbf6d34,135005,145825,4,11,10820,16,16
05292b38,135005,146185,8,5,11180,16,16
0490b2ab,135005,146545,11,4,11540,16,16
0b0e5b64,337045,337435,4,11,390,16,16
038f7556,337215,337805,6,3,590,16,16
03a3a208,337285,338175,8,3,890,16,16
05fc2f79,337055,338535,9,5,1480,16,16
09b12a0b,337355,339255,11,9,1900,16,16
0f8585ce,337195,339645,14,15,2450,16,16
03009728,337405,340175,8,3,2770,16,16
000994b7,438205,438705,7,0,500,16,16
0e064fd9,438325,439075,9,14,750,16,16
063da9ec,438305,439465,12,6,1160,16,16
02c42790,438255,440205,0,2,1950,16,16
0ccbc957,539315,539805,7,12,490,16,16
04535242,1095,1485,2,4,390,8,9
0895e816,12105,12645,1,8,540,8,9
004d6095,23065,23545,5,0,480,8,9
013e3015,23315,24055,5,1,740,8,9
05457ed3,34175,34815,1,5,640,8,9
007cd0d1,34065,35185,3,0,1120,8,9
00784c55,34405,35545,4,0,1140,8,9
00dcd3d2,34115,35905,5,0,1790,8,9
05df78c2,34275,36265,6,5,1990,8,9
04724c64,34385,36985,8,4,2600,8,9
01de9f90,34345,37345,0,1,3000,8,9
023d2aa7,34455,37705,1,2,3250,8,9
05696ce5,34915,38065,2,5,3150,8,9
04cdb8f3,34785,38425,3,4,3640,8,9
07e28bd3,35165,38785,4,7,3620,8,9
07845aa3,35715,39145,5,7,3430,8,9
00fdd6b8,36115,39505,6,0,3390,8,9
0162ad53,36185,39865,7,1,3680,8,9
048495c8,35115,40225,8,4,5110,8,9
0163eae8,36295,40585,0,1,4290,8,9
0474a026,36235,41315,3,4,5080,8,9
017d6534,36045,41675,4,1,5630,8,9
035816d0,135005,135385,0,3,380,8,9
002ae3f3,135005,135745,3,0,740,8,9
03617735,135005,136105,5,3,1100,8,9
04449236,135005,136465,6,4,1460,8,9
060f3784,135005,136825,4,6,1820,8,9
0379a0b8,135005,137185,8,3,2180,8,9
034569f6,135005,137905,6,3,2900,8,9
0012f961,135005,138265,1,0,3260,8,9
03a595b4,135005,138625,4,3,3620,8,9
06599fa5,135005,138985,5,6,3980,8,9
048fdf71,135005,139345,1,4,4340,8,9
06502bc3,135005,140065,3,6,5060,8,9
053327e5,135005,140425,5,5,5420,8,9
01da9f87,135005,140785,7,1,5780,8,9
08ec0d71,135005,141145,1,8,6140,8,9
08cdb125,135005,141505,5,8,6500,8,9
03e94df0,337055,337535,0,3,480,8,9
0290b2a1,337325,337895,1,2,570,8,9
0340cd02,337285,338255,2,3,970,8,9
03119794,337125,338625,4,3,1500,8,9
071ff445,337185,338985,5,7,1800,8,9
056adab8,337415,339715,8,5,2300,8,9
07fcf0e1,337515,340085,1,7,2570,8,9
079e94e3,539315,539725,3,7,410,8,9
05535241,1065,1455,1,5,390,7,6
0295e811,12025,12405,4,2,380,7,6
02284652,12205,12765,5,2,560,7,6
02f998d2,12175,13515,3,2,1340,7,6
0297b0d5,12155,13875,4,2,1720,7,6
05457ed1,23345,23915,1,5,570,7,6
05df78c0,34065,34525,4,5,460,7,6
03ff7e53,34455,34885,5,3,430,7,6
023d2aa4,34355,35605,1,2,1250,7,6
00de9f95,34165,35965,2,0,1800,7,6
05724c64,34185,36325,3,5,2140,7,6
02a4ec55,34805,37045,5,2,2240,7,6
013870a1,35155,37405,0,1,2250,7,6
04f62631,35055,37775,2,4,2720,7,6
0107ae80,34765,38135,3,1,3370,7,6
01e28bd5,34965,38495,4,1,3530,7,6
02726651,35035,38855,5,2,3820,7,6
050f3781,135005,135385,1,5,380,7,6
00fdd2a1,135005,135745,1,0,740,7,6
013327e2,135005,136105,2,1,1100,7,6
03421203,135005,136465,3,3,1460,7,6
00fdd6b1,135005,136825,1,0,1820,7,6
049650a1,135005,137185,1,4,2180,7,6
05513ae0,135005,137545,0,5,2540,7,6
02c603b1,135005,137905,1,2,2900,7,6
025fb4c3,135005,138265,3,2,3260,7,6
04572cf4,135005,138985,4,4,3980,7,6
02d945c0,337045,337475,0,2,430,7,6
00e32491,337205,337835,1,0,630,7,6
00bc05b3,337055,338205,3,0,1150,7,6
0533ed01,337295,338615,1,5,1320,7,6
047fc513,337425,338985,3,4,1560,7,6
04ccec23,438145,438555,3,4,410,7,6
0525a774,438285,438915,4,5,630,7,6
047edc80,438205,439285,0,4,1080,7,6
012ed3d0,438375,439735,0,1,1360,7,6
005816d2,539095,539495,2,0,400,7,6
05535242,1075,1475,2,5,400,4,9
0895e811,12035,12505,3,8,470,4,9
084d6093,12125,12875,5,8,750,4,9
00056634,23095,23525,4,0,430,4,9
0297b0d8,34025,34465,1,2,440,4,9
01df78c0,34415,34825,2,1,410,4,9
08752120,34155,35185,3,8,1030,4,9
03f998d5,34035,35545,4,3,1510,4,9
017cd0d6,34275,35905,5,1,1630,4,9
048495c5,35125,36265,6,4,1140,4,9
01069f23,34895,36625,7,1,1730,4,9
02dcd3d1,34385,36985,8,2,2600,4,9
013e3011,34225,37345,0,1,3120,4,9
06696ce6,34905,37705,1,6,2800,4,9
05784c52,34515,38065,2,5,3550,4,9
04cdb8f6,34815,38425,3,4,3610,4,9
003d2aa8,34565,38785,4,0,4220,4,9
083b8132,35735,39145,5,8,3410,4,9
07572cf5,36095,39505,6,7,3410,4,9
0803e963,35725,39865,7,8,4140,4,9
0163eae7,36035,40225,8,1,4190,4,9
05726653,35315,40585,0,5,5270,4,9
0574a021,36005,40945,1,5,4940,4,9
087d6537,35855,41305,2,8,5450,4,9
04cdb8f6,34815,41665,3,4,6850,4,9
003d2aa8,34565,42025,4,0,7460,4,9
083b8132,35735,42385,5,8,6650,4,9
08265b60,36845,42755,7,8,5910,4,9
07488781,135005,136105,1,7,1100,4,9
016333a0,135005,136465,0,1,1460,4,9
049a18f3,135005,137185,3,4,2180,4,9
08d945c1,135005,137545,1,8,2540,4,9
08caf2a1,337095,337555,1,8,460,4,9
07563582,337195,337915,2,7,720,4,9
06ff29c0,539145,539675,0,6,530,4,9
00535243,1085,1495,3,0,410,12,6
014d6095,12115,12835,3,1,720,12,6
0197b0d0,12235,13195,4,1,960,12,6
01056632,12185,13555,5,1,1370,12,6
01f998d1,12285,14005,5,1,1720,12,6
04284652,23095,23485,2,4,390,12,6
01dcd3d2,23445,23935,2,1,490,12,6
0414c3c2,135005,135385,2,4,380,12,6
035fb4c1,135005,136105,1,3,1100,12,6
01df78c1,135005,136465,1,1,1460,12,6
05a4ec55,135005,136825,5,5,1820,12,6
05513ae3,135005,137545,3,5,2540,12,6
02c4bd94,135005,137905,4,2,2900,12,6
0433ed05,135005,138265,5,4,3260,12,6
04696ce0,135005,138625,0,4,3620,12,6
05ccc9d2,135005,138985,2,5,3980,12,6
009650a3,135005,139345,3,0,4340,12,6
047edc85,337065,337455,5,4,390,12,6
0125a773,337155,338205,3,1,1050,12,6
035007e4,337285,338565,4,3,1280,12,6
0192f853,438295,438675,3,1,380,12,6
03488780,438365,439065,0,3,700,12,6
02bf6d31,438255,439425,1,2,1170,12,6
04caf2a3,539115,539505,3,4,390,12,6
04bb4a33,539595,540135,3,4,540,12,6
019a82f4,539645,540495,4,1,850,12,6
03617730,539535,541215,0,3,1680,12,6
0253524a,1005,1435,10,2,430,10,11
0995e815,12105,12525,3,9,420,10,11
09056631,12225,12955,8,9,730,10,11
094d6093,12125,13365,1,9,1240,10,11
0897b0d2,23065,23505,2,8,440,10,11
09284652,23165,24055,2,9,890,10,11
00ccec25,135005,135745,5,0,740,10,11
0192f85a,135005,136105,10,1,1100,10,11
00599fa5,135005,136465,5,0,1460,10,11
043e3012,135005,136825,2,4,1820,10,11
07ff7e5a,135005,137185,10,7,2180,10,11
00b582d9,135005,137545,9,0,2540,10,11
09c380d0,135005,137905,0,9,2900,10,11
0130acaa,135005,138265,10,1,3260,10,11
08bf9c6a,135005,138625,10,8,3620,10,11
0112f961,135005,139345,1,1,4340,10,11
0328f1f6,135005,139705,6,3,4700,10,11
04a0c8e1,135005,140065,1,4,5060,10,11
088fdf75,135005,140425,5,8,5420,10,11
07784c58,135005,140785,8,7,5780,10,11
078495c4,135005,141145,4,7,6140,10,11
0544923a,135005,141865,10,5,6860,10,11
0050deb5,135005,142225,5,0,7220,10,11
08c603b1,135005,142585,1,8,7580,10,11
08da9f85,135005,142945,5,8,7940,10,11
07fb6658,337145,337525,8,7,380,10,11
0836cda1,337105,337935,1,8,830,10,11
07ae2b55,438015,438465,5,7,450,10,11
03e94df6,438075,438825,6,3,750,10,11
0190b2a2,539165,540045,2,1,880,10,11
08102c33,539655,540405,3,8,750,10,11
05ebc9a4,539495,540765,4,5,1270,10,11
0b53524e,1015,1595,14,11,580,9,16
0b4d609a,12085,12915,13,11,830,9,16
0b95e817,12055,13385,4,11,1330,9,16
0b97b0d5,12195,13775,7,11,1580,9,16
0bf998dd,12285,14425,7,11,2140,9,16
0d284655,23015,23425,5,13,410,9,16
07752125,23115,24075,5,7,960,9,16
03df78c4,34415,34995,1,3,580,9,16
043e3016,34075,35355,2,4,1280,9,16
0a3d2aac,34685,35715,3,10,1030,9,16
01cdb8fa,34955,36085,5,1,1130,9,16
04e28bd4,35315,36445,6,4,1130,9,16
06dcd3d1,34255,36805,7,6,2550,9,16
0627277c,34825,37165,8,6,2340,9,16
02784c57,34625,37525,9,2,2900,9,16
0c2d6121,34915,37885,10,12,2970,9,16
08724c6c,34545,38245,11,8,3700,9,16
0972665f,35485,38605,12,9,3120,9,16
068bdf29,36745,38965,13,6,2220,9,16
01457ed8,34315,39325,14,1,5010,9,16
0274a027,36165,40045,0,2,3880,9,16
0d07ae84,35165,40405,1,13,5240,9,16
0cff7e50,34785,40765,2,12,5980,9,16
00ccc9da,35765,41125,3,0,5360,9,16
033870a4,35595,41855,6,3,6260,9,16
0f30aca8,36585,42215,7,15,5630,9,16
0b449235,36485,42575,8,11,6090,9,16
049650a7,36495,42935,9,4,6440,9,16
0663eae2,36225,43295,10,6,7070,9,16
0c14c3cd,36655,43655,11,12,7000,9,16
09572cf1,36395,44015,12,9,7620,9,16
0503e968,35835,44385,14,5,8550,9,16
0a421209,35685,44775,1,10,9090,9,16
04bc05b5,135005,135385,5,4,380,9,16
087edc84,135005,135745,4,8,740,9,16
01ff29c6,135005,136465,6,1,1460,9,16
0ee94df9,135005,137185,9,14,2180,9,16
0bf72fdd,135005,137545,13,11,2540,9,16
0dbc4b82,135005,137905,2,13,2900,9,16
0e5e276b,135005,138265,11,14,3260,9,16
077901c2,135005,138985,2,7,3980,9,16
02779fa6,135005,139345,6,2,4340,9,16
059837d8,135005,139705,8,5,4700,9,16
05b34d8e,135005,140065,14,5,5060,9,16
0979a0b8,135005,140425,8,9,5420,9,16
00c4bd9f,135005,140785,15,0,5780,9,16
0ed7f0cb,135005,141145,11,14,6140,9,16
0d28f1f0,135005,141505,0,13,6500,9,16
0ef38869,135005,141865,9,14,6860,9,16
0a8565fa,135005,142225,10,10,7220,9,16
08fb6652,135005,142585,2,8,7580,9,16
03daddcf,135005,142945,15,3,7940,9,16
05e8a38d,135005,143305,13,5,8300,9,16
000b7d9c,135005,143665,12,0,8660,9,16
0e807695,135005,144025,5,14,9020,9,16
0a199ba8,135005,144745,8,10,9740,9,16
0859f269,135005,145105,9,8,10100,9,16
0ed2b795,135005,145465,5,14,10460,9,16
0c502bc2,135005,145825,2,12,10820,9,16
0aa4b15e,135005,146185,14,10,11180,9,16
0d4569f6,135005,146545,6,13,11540,9,16
06a8a29f,337045,337655,15,6,610,9,16
09c42731,539205,539895,1,9,690,9,16
04535243,1075,1695,3,4,620,14,16
074d6097,12185,12665,1,7,480,14,16
0795e81c,12105,13095,6,7,990,14,16
03056631,23045,23665,1,3,620,14,16
0adf78c1,23615,24315,1,10,700,14,16
08784c51,23845,24965,1,8,1120,14,16
0c3d2aa4,34045,34425,5,12,380,14,16
08cdb8ff,34185,35165,9,8,980,14,16
01272775,34105,35555,12,1,1450,14,16
0f2d6125,34135,35915,13,15,1780,14,16
03696ce4,34345,36275,14,3,1930,14,16
0f07ae89,34425,36645,0,15,2220,14,16
04069f25,34275,37015,2,4,2740,14,16
06e28bd6,34615,37385,4,6,2770,14,16
0a726652,34735,37875,12,10,3140,14,16
098495c0,34525,38245,14,9,3720,14,16
0ab582da,34675,38655,2,10,3980,14,16
0a5fb4cd,135005,135385,13,10,380,14,16
06b4b49d,135005,136105,13,6,1100,14,16
0290d445,135005,136465,5,2,1460,14,16
0fbc4b8b,135005,137185,11,15,2180,14,16
0749b041,135005,137545,1,7,2540,14,16
0656786d,135005,137905,13,6,2900,14,16
09921c01,135005,138265,1,9,3260,14,16
08578a1d,135005,138625,13,8,3620,14,16
0ab80a84,135005,138985,4,10,3980,14,16
04f41132,135005,139345,2,4,4340,14,16
06e5ebd7,135005,139705,7,6,4700,14,16
02572cfa,135005,140425,10,2,5420,14,16
05513aef,135005,140785,15,5,5780,14,16
047fc514,135005,141145,4,4,6140,14,16
06488784,135005,141505,4,6,6500,14,16
0c292b34,135005,141865,4,12,6860,14,16
011ff443,135005,142225,3,1,7220,14,16
04e8a389,135005,142585,9,4,7580,14,16
0637195f,135005,142945,15,6,7940,14,16
08e07297,135005,143305,7,8,8300,14,16
0076137c,135005,143665,12,0,8660,14,16
04cee61e,135005,144025,14,4,9020,14,16
040168a4,135005,144385,4,4,9380,14,16
034e3c83,135005,144745,3,3,9740,14,16
0a794f25,135005,145105,5,10,10100,14,16
0114875a,135005,145465,10,1,10460,14,16
0c63eae7,135005,145825,7,12,10820,14,16
00265b67,135005,146185,7,0,11180,14,16
0cc4bd90,135005,146545,0,12,11540,14,16
08dbf6b2,337035,337715,2,8,680,14,16
0fe45924,438135,438515,4,15,380,14,16
0e4df285,438235,438875,5,14,640,14,16
0afb4aec,438065,439345,12,10,1280,14,16
083819bf,438075,439735,15,8,1660,14,16
044e02d5,438295,440185,5,4,1890,14,16
099b0c22,539115,539525,2,9,410,14,16
0ccf61ee,539135,540095,14,12,960,14,16
0495e811,12105,12505,2,4,400,14,5
04056634,12235,12865,3,4,630,14,5
04f998d3,12355,13585,0,4,1230,14,5
0497b0d4,12295,13945,1,4,1650,14,5
04752120,12505,14305,2,4,1800,14,5
043e3012,12515,15035,0,4,2520,14,5
04dcd3d0,12575,15405,2,4,2830,14,5
01457ed3,23045,23425,3,1,380,14,5
023d2aa3,23365,23855,3,2,490,14,5
012d6123,23625,24285,3,1,660,14,5
01069f21,34175,34975,4,1,800,14,5
00c380d2,135005,135385,2,0,380,14,5
014b3411,135005,135745,1,1,740,14,5
04c603b3,135005,136105,3,4,1100,14,5
03bc05b2,135005,136465,2,3,1460,14,5
0207ae84,135005,136825,4,2,1820,14,5
028bdf24,135005,137185,4,2,2180,14,5
03cdb123,135005,138265,3,3,3260,14,5
0303e961,135005,138625,1,3,3620,14,5
009e7394,337085,337535,4,0,450,14,5
04bf6d30,337205,337895,0,4,690,14,5
03a595b2,337355,338265,2,3,910,14,5
0092f853,337235,338625,3,0,1390,14,5
0228f1f4,337125,338985,4,2,1860,14,5
03f38864,438255,438685,4,3,430,14,5
03caf2a0,438145,439045,0,3,900,14,5
00a0c8e1,438335,439405,1,0,1070,14,5
00617732,438545,439765,2,0,1220,14,5
01ff29c3,438365,440125,3,1,1760,14,5
02599fa0,438445,440495,0,2,2050,14,5
04dbc263,438525,440885,3,4,2360,14,5
00bb4a33,539035,539425,3,0,390,14,5
028565f4,539285,539925,4,2,640,14,5
018db5a0,539495,540285,0,1,790,14,5
0491ae61,539445,540645,1,4,1200,14,5
0595e81b,12095,12525,6,5,430,14,13
0597b0d8,12325,12975,12,5,650,14,13
05056638,12225,13445,6,5,1220,14,13
04f998d1,23095,23685,1,4,590,14,13
00df78c1,23555,24275,1,0,720,14,13
06de9f91,34055,34485,4,6,430,14,13
0c784c58,34125,34855,6,12,730,14,13
0707ae8b,34565,35225,8,7,660,14,13
013d2aa0,34175,35585,9,1,1410,14,13
03724c61,34075,36305,11,3,2230,14,13
07a4ec5a,34605,36665,12,7,2060,14,13
08fdd6b7,35455,37025,0,8,1570,14,13
04272778,34245,37385,1,4,3140,14,13
05c380d8,35305,37745,2,5,2440,14,13
05e28bd5,34675,38105,3,5,3430,14,13
038495c5,34625,38465,4,3,3840,14,13
0b8bdf26,35955,38825,5,11,2870,14,13
0b696ce7,34485,39185,6,11,4700,14,13
09726659,34845,39545,7,9,4700,14,13
0003e961,35155,39905,8,0,4750,14,13
04a12898,36295,40985,11,4,4690,14,13
0950deb5,36385,41705,0,9,5320,14,13
0c7be71c,36875,42065,1,12,5190,14,13
066333ac,37115,42785,3,6,5670,14,13
037d653b,35405,43145,4,3,7740,14,13
07c603bc,37025,43505,5,7,6480,14,13
049650a0,35815,43865,6,4,8050,14,13
00241852,36935,44225,7,0,7290,14,13
0c513ae0,36615,44595,9,12,7980,14,13
0399bf15,37295,44965,11,3,7670,14,13
093327e8,37195,45325,12,9,8130,14,13
0730762c,37425,45685,0,7,8260,14,13
07fcd848,135005,135385,8,7,380,14,13
061559fc,135005,135745,12,6,740,14,13
09ccec29,135005,136105,9,9,1100,14,13
0b2ae3f1,135005,136465,1,11,1460,14,13
018fdf71,135005,136825,1,1,1820,14,13
044bf942,135005,137545,2,4,2540,14,13
00261f70,135005,137905,0,0,2900,14,13
0a408da0,135005,138265,0,10,3260,14,13
0359f26c,135005,138625,12,3,3620,14,13
06791860,135005,138985,0,6,3980,14,13
03efda94,135005,139345,4,3,4340,14,13
060c96b8,135005,139705,8,6,4700,14,13
018568f8,135005,140065,8,1,5060,14,13
0c12f967,135005,140425,7,12,5420,14,13
00a595b7,135005,140785,7,0,5780,14,13
018565f4,135005,141145,4,1,6140,14,13
0240cd08,135005,141505,8,2,6500,14,13
0c187792,135005,141865,2,12,6860,14,13
0071a464,135005,142225,4,0,7220,14,13
0b7901ca,135005,142585,10,11,7580,14,13
02737969,135005,142945,9,2,7940,14,13
018d14e5,135005,143665,5,1,8660,14,13
07345cac,135005,144025,12,7,9020,14,13
06521323,135005,144385,3,6,9380,14,13
02e45929,337045,337875,9,2,830,14,13
0875f4ba,337225,338235,10,8,1010,14,13
059fdecb,337375,338595,11,5,1220,14,13
024e02d0,337135,338965,0,2,1830,14,13
089b0c24,337245,339705,4,8,2460,14,13
0ae1bd18,337475,340455,8,10,2980,14,13
03cf61e0,337265,340885,0,3,3620,14,13
0361c868,337555,341375,8,3,3820,14,13
01fe9537,438205,438965,7,1,760,14,13
073e2044,539165,539595,4,7,430,14,13
02535246,1055,1515,6,2,460,8,13
024d6099,12075,12525,6,2,450,8,13
02f998d4,12245,12895,8,2,650,8,13
0295e814,12065,13325,0,2,1260,8,13
02056632,12155,14085,5,2,1930,8,13
02752122,12355,14575,0,2,2220,8,13
0228465a,12295,15005,5,2,2710,8,13
043e3010,23035,23415,0,4,380,8,13
02457ed0,23295,24005,0,2,710,8,13
06df78c5,34015,34625,11,6,610,8,13
08de9f94,34085,35015,1,8,930,8,13
083d2aab,34205,35375,2,8,1170,8,13
00ff7e57,34285,35735,3,0,1450,8,13
08784c5a,34175,36105,5,8,1930,8,13
01696ceb,34585,36465,6,1,1880,8,13
05a4ec52,34625,37185,8,5,2560,8,13
058495c6,34685,37905,10,5,3220,8,13
05513ae6,36655,38265,11,5,1610,8,13
07726658,34825,38625,12,7,3800,8,13
0914c3c1,35945,38985,0,9,3040,8,13
08b582d4,34815,39345,1,8,4530,8,13
002d6127,34345,39705,2,0,5360,8,13
093b813b,35245,40065,3,9,4820,8,13
009650a0,35845,40425,4,0,4580,8,13
04b34d81,36185,41145,6,4,4960,8,13
0b241859,36885,41505,7,11,4620,8,13
07a12899,36325,41865,8,7,5540,8,13
0c3327e2,36985,42225,9,12,5240,8,13
052554f4,36925,42585,10,5,5660,8,13
08fdd2aa,36755,42955,12,8,6200,8,13
058bdf27,36025,43675,1,5,7650,8,13
07a4b154,37085,44035,2,7,6950,8,13
07502bc4,36685,44395,3,7,7710,8,13
0a99bf19,37105,44755,4,10,7650,8,13
016333a6,36965,45125,6,1,8160,8,13
087a6fd6,135005,135385,6,8,380,8,13
05307627,135005,135745,7,5,740,8,13
05bc05bb,135005,136105,11,5,1100,8,13
01ccec23,135005,136465,3,1,1460,8,13
0428f1fc,135005,136825,12,4,1820,8,13
0a563584,135005,137185,4,10,2180,8,13
039a82f2,135005,137545,2,3,2540,8,13
0bfc1299,135005,137905,9,11,2900,8,13
0940cd03,135005,138265,3,9,3260,8,13
01eed569,135005,138625,9,1,3620,8,13
054bf949,135005,138985,9,5,3980,8,13
015e276c,135005,139345,12,1,4340,8,13
05ebab45,135005,139705,5,5,4700,8,13
01ea7669,135005,140065,9,1,5060,8,13
044569f4,135005,140425,4,4,5420,8,13
0812f961,135005,140785,1,8,5780,8,13
0a5816d8,135005,141145,8,10,6140,8,13
002ae3f9,135005,141505,9,0,6500,8,13
05617738,135005,141865,8,5,6860,8,13
0791ae60,135005,142225,0,7,7220,8,13
04119797,135005,142585,7,4,7580,8,13
0af72fd0,135005,142945,0,10,7940,8,13
0b187795,135005,143305,5,11,8300,8,13
0b0b7d9a,135005,143665,10,11,8660,8,13
06261f7a,135005,144025,10,6,9020,8,13
057e4084,135005,144385,4,5,9380,8,13
03e05d56,337055,337475,6,3,420,8,13
0a4f61a9,337075,337865,9,10,790,8,13
0c000b93,337085,338335,3,12,1250,8,13
0159f265,438125,438525,5,1,400,8,13
069837d9,438275,438935,9,6,660,8,13
03921c0a,438075,439295,10,3,1220,8,13
0873796b,438055,439655,11,8,1600,8,13
0a61ab6c,438215,440015,12,10,1800,8,13
093b6cf2,539385,539775,2,9,390,8,13
07d80db3,539345,540135,3,7,790,8,13
02535243,1025,1535,3,2,510,9,7
0695e810,12025,12485,0,6,460,9,7
06f998d1,12105,12845,1,6,740,9,7
064d6094,12045,13205,2,6,1160,9,7
0697b0d0,12095,13595,5,6,1500,9,7
06284656,12175,13965,0,6,1790,9,7
06752124,12275,14325,1,6,2050,9,7
023e3011,23095,23505,1,2,410,9,7
057cd0d6,34035,34505,1,5,470,9,7
04df78c1,34265,34865,2,4,600,9,7
04724c62,34455,35225,3,4,770,9,7
06069f26,34925,35585,4,6,660,9,7
04696ce3,35025,35945,5,4,920,9,7
032d6121,34815,36305,6,3,1490,9,7
01457ed6,34185,36665,0,1,2480,9,7
0107ae83,35055,37745,3,1,2690,9,7
033870a0,35495,38105,4,3,2610,9,7
04fe91d0,36165,39545,1,4,3380,9,7
01fdd6b6,35985,39905,2,1,3920,9,7
019650a4,36385,40265,3,1,3880,9,7
066333a1,135005,135385,1,6,380,9,7
00da9f83,135005,135745,3,0,740,9,7
017fc515,135005,136105,5,1,1100,9,7
015816d3,135005,136465,3,1,1460,9,7
04bf9c63,135005,137545,3,4,2540,9,7
031559f6,135005,137905,6,3,2900,9,7
0633ed05,135005,138265,5,6,3260,9,7
01cdb122,135005,138625,2,1,3620,9,7
06b4b492,135005,138985,2,6,3980,9,7
0350deb3,135005,139705,3,3,4700,9,7
059a82f3,337025,337415,3,5,390,9,7
06292b34,337095,337775,4,6,680,9,7
0191ae66,337395,338145,6,1,750,9,7
05b36cb1,337355,338515,1,5,1160,9,7
018fdf72,337275,338875,2,1,1600,9,7
0290d443,337265,339235,3,2,1970,9,7
058565f4,337195,339595,4,5,2400,9,7
058db5a2,337485,340025,2,5,2540,9,7
04fb6650,438145,438595,0,4,450,9,7
0436cda1,438105,438955,1,4,850,9,7
001ff441,539115,539505,1,0,390,9,7
0340cd02,539215,540035,2,3,820,9,7
00f72fd5,539645,540765,5,0,1120,9,7
0795e81c,12095,12665,9,7,570,10,14
073e301d,12485,13095,0,7,610,10,14
074d6093,12185,13455,1,7,1270,10,14
0797b0d3,12295,13815,2,7,1520,10,14
07284651,12375,14175,3,7,1800,10,14
07f998db,12365,14545,5,7,2180,10,14
07752129,12475,15115,3,7,2640,10,14
007cd0db,23085,23705,11,0,620,10,14
01457edb,23285,24315,11,1,1030,10,14
02df78c9,34085,34585,5,2,500,10,14
01272773,34345,34945,6,1,600,10,14
0dde9f93,34135,35315,8,13,1180,10,14
022d6121,34395,35685,10,2,1290,10,14
0b069f2c,34525,36055,12,11,1530,10,14
03ff7e53,34335,36415,13,3,2080,10,14
0907ae8d,34595,36775,0,9,2180,10,14
0b724c64,34195,37165,3,11,2970,10,14
01784c5a,34265,37525,4,1,3260,10,14
093d2aa3,34305,37885,5,9,3580,10,14
0d8495c0,34635,38245,6,13,3610,10,14
0da4ec58,34625,38615,8,13,3990,10,14
0c72665b,34825,39045,13,12,4220,10,14
06b582d9,34775,39405,0,6,4630,10,14
05f62635,34895,39795,3,5,4900,10,14
05e28bdc,34715,40155,4,5,5440,10,14
0dfb6659,135005,135385,9,13,380,10,14
02ebc9ab,135005,135745,11,2,740,10,14
04bc4b83,135005,136105,3,4,1100,10,14
0ab49cad,135005,136465,13,10,1460,10,14
0b0042dd,135005,136825,13,11,1820,10,14
04421205,135005,137185,5,4,2180,10,14
0263eae2,135005,137545,2,2,2540,10,14
00b34d8b,135005,137905,11,0,2900,10,14
067be71a,135005,138265,10,6,3260,10,14
025fb4cb,135005,138625,11,2,3620,10,14
0133ed0b,135005,138985,11,1,3980,10,14
0a5007ec,135005,139345,12,10,4340,10,14
08caf2ac,135005,139705,12,8,4700,10,14
09292b39,135005,140065,9,9,5060,10,14
0dfcf0e7,135005,140425,7,13,5420,10,14
0de8a38c,135005,140785,12,13,5780,10,14
0d4266dc,135005,141145,12,13,6140,10,14
0618d884,135005,141505,4,6,6500,10,14
0356786a,135005,141865,10,3,6860,10,14
07e618a7,135005,142585,7,7,7580,10,14
03fdd2a9,135005,142945,9,3,7940,10,14
01c4bd96,135005,143305,6,1,8300,10,14
06e3789a,135005,143665,10,6,8660,10,14
062ed3d1,135005,144025,1,6,9020,10,14
0ab4b494,135005,144385,4,10,9380,10,14
02bb4a3c,135005,144745,12,2,9740,10,14
032e2edb,135005,145105,11,3,10100,10,14
05e05d53,337035,337415,3,5,380,10,14
044f61a6,337095,337805,6,4,710,10,14
0b000b98,337195,338175,8,11,980,10,14
0c61ab6a,337485,338545,10,12,1060,10,14
069837d2,337535,339325,2,6,1790,10,14
09761373,337285,339685,3,9,2400,10,14
0d737966,337375,340075,6,13,2700,10,14
06f0fdc8,337595,340445,8,6,2850,10,14
0d59f263,337475,340955,3,13,3480,10,14
03d80dbd,438265,438805,13,3,540,10,14
09a9b7e0,438195,439165,0,9,970,10,14
0a3b6cf2,438365,439535,2,10,1170,10,14
04d2b795,438435,439925,5,4,1490,10,14
05791861,539345,539995,1,5,650,10,14
07535248,1065,1515,8,7,450,16,10
0695e813,12075,12545,9,6,470,16,10
06284655,12375,12905,0,6,530,16,10
064d6092,12095,13265,1,6,1170,16,10
06056632,12145,13655,4,6,1510,16,10
06752123,12455,14065,8,6,1610,16,10
06f998d8,12325,14515,4,6,2190,16,10
073e3013,23075,23625,3,7,550,16,10
02dcd3d3,23285,24155,3,2,870,16,10
05457ed2,34045,34445,4,5,400,16,10
04272775,34365,34815,6,4,450,16,10
09784c57,34265,35175,7,9,910,16,10
09e28bd0,34875,35535,8,9,660,16,10
05ff7e53,34345,35895,9,5,1550,16,10
09de9f96,34165,36255,0,9,2090,16,10
093d2aa3,34295,36615,1,9,2320,16,10
05724c65,34255,36975,2,5,2720,16,10
00696ce8,34575,37695,4,0,3120,16,10
03726652,34975,38055,5,3,3080,16,10
00572cf5,35885,38415,6,0,2530,16,10
023870a9,35155,38775,7,2,3620,16,10
06fdd6b4,35545,39135,8,6,3590,16,10
0874a022,35655,39495,9,8,3840,16,10
0314c3c2,36065,39855,0,3,3790,16,10
07ccc9d5,35325,40215,1,7,4890,16,10
00069f25,34515,40575,2,0,6060,16,10
07265b64,36365,40935,3,7,4570,16,10
006333a8,36745,41295,4,0,4550,16,10
027be713,36595,41655,5,2,5060,16,10
087d6536,35535,42375,7,8,6840,16,10
02241855,36635,42735,8,2,6100,16,10
04fdd2a2,36505,43095,9,4,6590,16,10
092554f2,36655,43455,0,9,6800,16,10
00c603b9,36725,43815,1,0,7090,16,10
01b4b493,135005,135745,3,1,740,16,10
01b36cb1,135005,136105,1,1,1100,16,10
09cde4d7,135005,136825,7,9,1820,16,10
04c9c2e9,135005,137185,9,4,2180,16,10
034f61a5,135005,137545,5,3,2540,16,10
00cee615,135005,137905,5,0,2900,16,10
08b80a81,135005,138265,1,8,3260,16,10
02a4b159,135005,138625,9,2,3620,16,10
07488786,135005,138985,6,7,3980,16,10
0590d441,135005,139345,1,5,4340,16,10
09fcf0e8,135005,139705,8,9,4700,16,10
087ca592,135005,140065,2,8,5060,16,10
030042d3,135005,140425,3,3,5420,16,10
05d2b793,135005,141145,3,5,6140,16,10
000168a6,135005,141505,6,0,6500,16,10
07f41132,135005,141865,2,7,6860,16,10
0233ed03,135005,142225,3,2,7220,16,10
0959dba0,337095,337555,0,9,460,16,10
05b3b7f3,337525,337945,3,5,420,16,10
026abc45,337175,338665,5,2,1490,16,10
00fcd846,337725,339025,6,0,1300,16,10
02e5ebd9,337715,339755,9,2,2040,16,10
01df5fa0,337615,340115,0,1,2500,16,10
033cfca1,337775,340475,1,3,2700,16,10
07794f22,337645,340835,2,7,3190,16,10
09521323,337695,341195,3,9,3500,16,10
0769ab45,337425,341565,5,7,4140,16,10
02b6afb4,438325,438855,4,2,530,16,10
0683dc95,438445,439215,5,6,770,16,10
05148757,438485,439585,7,5,1100,16,10
040e5368,438475,439945,8,4,1470,16,10
07290ef9,438415,440305,9,7,1890,16,10
095e7884,438675,440735,4,9,2060,16,10
00dbf6b5,438655,441095,5,0,2440,16,10
07fb4ae0,539085,539565,0,7,480,16,10
093050d3,539465,540105,3,9,640,16,10
039fdec4,539565,540465,4,3,900,16,10
0775f4b5,539355,540825,5,7,1470,16,10
03024416,539685,541185,6,3,1500,16,10
09e1bd18,539665,541555,8,9,1890,16,10
0d535247,1035,1615,7,13,580,7,14
0405663b,12165,12545,3,4,380,7,14
044d6092,12095,12935,6,4,840,7,14
0495e815,12045,13305,8,4,1260,7,14
0297b0d1,23085,23505,1,2,420,7,14
0a3f1761,23445,24115,1,10,670,7,14
04dcd3dd,34025,34425,11,4,400,7,14
03272773,34365,34795,13,3,430,7,14
0c457ed7,34115,35155,0,12,1040,7,14
09724c69,34215,35515,1,9,1300,7,14
04b22804,35125,35875,2,4,750,7,14
08f62633,34995,36235,3,8,1240,7,14
00de9f9d,34175,36595,4,0,2420,7,14
02069f29,34575,36955,5,2,2380,7,14
04ccc9dd,35255,37315,6,4,2060,7,14
08ff7e5d,34315,37675,7,8,3360,7,14
0b784c53,34285,38035,8,11,3750,7,14
07cdb8f1,34495,38395,9,7,3900,7,14
0374a029,35645,39475,12,3,3830,7,14
0903e961,35325,39835,13,9,4510,7,14
093870a3,35065,40195,0,9,5130,7,14
03845aa8,35195,40565,2,3,5370,7,14
01572cfa,35805,40925,3,1,5120,7,14
027d6538,35465,41285,4,2,5820,7,14
0963eaea,35665,41655,6,9,5990,7,14
0c8bdf27,36075,42015,7,12,5940,7,14
0ca4ec54,34755,42375,8,12,7620,7,14
0d8495c0,34845,42735,9,13,7890,7,14
0330acab,35945,43095,10,3,7150,7,14
05e618a6,36085,43815,12,5,7730,7,14
0214c3cc,36005,44175,13,2,8170,7,14
0b8fdf72,135005,135385,2,11,380,7,14
01fb6657,135005,135745,7,1,740,7,14
0a6adab9,135005,136105,9,10,1100,7,14
029e94ed,135005,136465,13,2,1460,7,14
074bf941,135005,136825,1,7,1820,7,14
01b34d87,135005,137185,7,1,2180,7,14
0c502bc7,135005,137545,7,12,2540,7,14
076333a9,135005,137905,9,7,2900,7,14
081559f5,135005,138265,5,8,3260,7,14
02e37896,135005,138625,6,2,3620,7,14
02ccec2c,135005,138985,12,2,3980,7,14
039e739a,135005,139345,10,3,4340,7,14
062ae3f9,135005,139705,9,6,4700,7,14
06dbc264,135005,140065,4,6,5060,7,14
0140cd05,135005,140785,5,1,5780,7,14
09102c3a,135005,141145,10,9,6140,7,14
01187791,135005,141505,1,1,6500,7,14
00cde4d6,135005,141865,6,0,6860,7,14
07bf9c67,135005,142225,7,7,7220,7,14
002554fc,135005,142585,12,0,7580,7,14
0730762b,135005,142945,11,7,7940,7,14
05d945c9,135005,143305,9,5,8300,7,14
0d12f967,135005,143665,7,13,8660,7,14
005007e1,135005,144025,1,0,9020,7,14
0ca595b2,135005,144385,2,12,9380,7,14
0bff29c9,135005,144745,9,11,9740,7,14
098565fd,135005,145105,13,9,10100,7,14
005e276b,337045,337575,11,0,530,7,14
0c72db64,438035,438465,4,12,430,7,14
00371955,438105,438825,5,0,720,7,14
0771a46c,438185,439295,12,7,1110,7,14
04b49ca1,438025,439685,1,4,1660,7,14
00807695,539235,539685,5,0,450,7,14
02535240,1005,1435,0,2,430,8,3
0195e812,12025,12445,0,1,420,8,3
014d6091,12105,12815,2,1,710,8,3
01f998d2,12255,13175,0,1,920,8,3
01752121,12365,13545,2,1,1180,8,3
023f1761,34065,34445,0,2,380,8,3
027cd0d2,34055,34805,1,2,750,8,3
022d6120,135005,135745,0,2,740,8,3
00b582d1,135005,136105,1,0,1100,8,3
008495c1,135005,136825,1,0,1820,8,3
01845aa2,135005,137185,2,1,2180,8,3
0063eae2,337045,337455,2,0,410,8,3
00572cf1,337105,338175,1,0,1070,8,3
014b3412,438085,438815,2,1,730,8,3
0250deb1,539215,539645,1,2,430,8,3
09535245,1005,1455,5,9,450,11,10
0595e815,12055,12505,7,5,450,11,10
05284651,12315,12865,8,5,550,11,10
05056630,12115,13225,9,5,1110,11,10
054d6091,12105,13615,2,5,1510,11,10
0597b0d0,12165,13975,3,5,1810,11,10
05f998d6,12215,14365,6,5,2150,11,10
053e3011,12375,14735,8,5,2360,11,10
007cd0d1,23105,23585,1,0,480,11,10
063d2aa1,23445,24115,1,6,670,11,10
02ff7e53,34075,34525,8,2,450,11,10
05696ce2,34435,34895,0,5,460,11,10
01b582d0,34595,35265,2,1,670,11,10
072d6122,34235,35625,3,7,1390,11,10
08069f20,34365,35985,4,8,1620,11,10
00272771,34165,36345,5,0,2180,11,10
08cdb8f8,34295,36705,6,8,2410,11,10
05ccc9d3,34955,37425,8,5,2470,11,10
02b22809,34775,37795,0,2,3020,11,10
06845aa4,34925,38155,1,6,3230,11,10
047d6538,35155,38515,2,4,3360,11,10
073b8137,34975,38875,3,7,3900,11,10
0914c3c4,35715,39235,4,9,3520,11,10
07e618a8,35825,39595,5,7,3770,11,10
090f3788,35965,39955,6,9,3990,11,10
05449234,35625,40315,7,5,4690,11,10
00a12894,35985,40675,8,0,4690,11,10
09b34d80,35865,41045,0,9,5180,11,10
0350deb6,36005,41405,1,3,5400,11,10
069650a8,35635,41765,2,6,6130,11,10
02265b64,36095,42125,3,2,6030,11,10
0599bf16,135005,135385,6,5,380,11,10
09e37896,135005,135745,6,9,740,11,10
09cdb126,135005,136105,6,9,1100,11,10
09caf2a8,135005,136465,8,9,1460,11,10
04e94df8,135005,137185,8,4,2180,11,10
06eed569,135005,137545,9,6,2540,11,10
067ca599,135005,137905,9,6,2900,11,10
01513ae0,135005,138625,0,1,3620,11,10
05d945c9,135005,138985,9,5,3980,11,10
0125a775,135005,139345,5,1,4340,11,10
099a82f6,135005,140065,6,9,5060,11,10
00f72fd7,135005,140785,7,0,5780,11,10
0065d932,135005,141145,2,0,6140,11,10
0571a460,135005,141505,0,5,6500,11,10
001451c1,135005,141865,1,0,6860,11,10
063327e0,135005,142225,0,6,7220,11,10
05ea7667,337085,337495,7,5,410,11,10
035c4706,539065,539535,6,3,470,11,10
08535241,1045,1575,1,8,530,3,10
0595e814,12085,12525,8,5,440,3,10
054d6098,12145,13015,6,5,870,3,10
05056630,12245,13375,7,5,1130,3,10
0597b0d9,23035,23545,9,5,510,3,10
09284653,34135,34525,8,9,390,3,10
037cd0d0,34255,34885,9,3,630,3,10
08cdb8f7,34655,35245,0,8,590,3,10
053e3010,34205,36685,4,5,2480,3,10
00069f28,34755,37045,5,0,2290,3,10
093f1769,34335,37405,6,9,3070,3,10
01272777,34595,37765,7,1,3170,3,10
06784c50,34505,38125,8,6,3620,3,10
03dcd3d1,34395,38485,9,3,4090,3,10
0907ae89,34805,38845,0,9,4040,3,10
06ff7e52,34575,39205,1,6,4630,3,10
003b8135,35545,39565,2,0,4020,3,10
052d6127,34615,39925,3,5,5310,3,10
06de9f97,34465,40285,4,6,5820,3,10
04e28bd2,34995,40645,5,4,5650,3,10
088495c5,34935,41015,7,8,6080,3,10
04b582d7,35055,41375,8,4,6320,3,10
05f62631,35155,41735,9,5,6580,3,10
05b22800,35305,42095,0,5,6790,3,10
06572cf2,135005,135385,2,6,380,3,10
0030aca5,135005,135745,5,0,740,3,10
01e618a3,135005,136105,3,1,1100,3,10
030f3788,135005,136465,8,3,1460,3,10
00265b62,135005,136825,2,0,1820,3,10
08502bc1,135005,137185,1,8,2180,3,10
067be711,135005,137545,1,6,2540,3,10
05c603b8,135005,137905,8,5,2900,3,10
08a4b153,135005,138265,3,8,3260,3,10
0574a027,135005,138625,7,5,3620,3,10
051559f6,337035,337475,6,5,440,3,10
089a18f7,438065,438555,7,8,490,3,10
09da9f81,438165,438965,1,9,800,3,10
06d60b79,539085,539615,9,6,530,3,10
00535242,1045,1475,2,0,430,9,3
0295e811,12065,12465,1,2,400,9,3
0297b0d1,12235,13185,0,2,950,9,3
02056632,12195,13545,1,2,1350,9,3
02752120,12345,14265,0,2,1920,9,3
013e3012,23075,23485,2,1,410,9,3
00de9f92,23455,23875,2,0,420,9,3
02784c51,34075,34805,1,2,730,9,3
02a4ec51,34425,35525,0,2,1100,9,3
008495c0,34465,35885,1,0,1420,9,3
01b22800,34885,36245,2,1,1360,9,3
0162ad50,35515,36605,0,1,1090,9,3
0003e960,35115,36965,1,0,1850,9,3
0174a021,35555,37325,2,1,1770,9,3
0003e960,35115,38045,1,0,2930,9,3
0174a021,35555,38405,2,1,2850,9,3
0279a0b0,135005,135385,0,2,380,9,3
00c4bd92,135005,135745,2,0,740,9,3
01bc05b1,135005,136105,1,1,1100,9,3
02a4b150,135005,136465,0,2,1460,9,3
01d7f0c1,135005,137185,1,1,2180,9,3
017edc80,337035,337415,0,1,380,9,3
0125a772,337105,337785,2,1,680,9,3
012ed3d0,438085,438495,0,1,410,9,3
01cdb122,438155,438865,2,1,710,9,3
04535242,1075,1475,2,4,400,6,9
0895e813,12055,12565,6,8,510,6,9
084d6098,12125,12975,1,8,850,6,9
08056633,23035,23505,3,8,470,6,9
04752123,23325,24015,3,4,690,6,9
053e3014,34045,34445,0,5,400,6,9
00724c66,34445,35195,4,0,750,6,9
03784c56,34475,35555,5,3,1080,6,9
083f1767,34185,35915,6,8,1730,6,9
00726658,35335,36275,7,0,940,6,9
05dcd3d7,34205,36635,8,5,2430,6,9
0707ae84,35065,36995,0,7,1930,6,9
052d6124,34775,37355,1,5,2580,6,9
05b582d4,35245,37715,2,5,2470,6,9
05696ce3,34985,38075,3,5,3090,6,9
06cdb8f3,34825,38435,4,6,3610,6,9
038495c3,35145,38795,5,3,3650,6,9
0703e964,35775,39155,6,7,3380,6,9
05fdd6b3,36045,39515,7,5,3470,6,9
053870a6,35455,39875,8,5,4420,6,9
08e28bd4,35235,40235,0,8,5000,6,9
02421203,35505,40595,1,2,5090,6,9
0114c3c5,36455,40955,2,1,4500,6,9
000f3784,36655,41675,4,0,5020,6,9
06449238,36375,42035,5,6,5660,6,9
08e618a8,36565,42395,6,8,5830,6,9
03502bc5,37015,42755,7,3,5740,6,9
03265b67,36835,43115,8,3,6280,6,9
052ae3f7,135005,135385,7,5,380,6,9
01599fa2,135005,135745,2,1,740,6,9
078565f7,135005,136105,7,7,1100,6,9
05c603b5,135005,136465,5,5,1460,6,9
07307625,135005,136825,5,7,1820,6,9
034569f2,135005,137185,2,3,2180,6,9
00ec0d74,135005,137545,4,0,2540,6,9
0825a770,135005,137905,0,8,2900,6,9
0228f1f1,135005,138265,1,2,3260,6,9
00a0c8e3,135005,138625,3,0,3620,6,9
089a82f7,135005,138985,7,8,3980,6,9
0299bf15,135005,139705,5,2,4700,6,9
05da9f88,135005,140065,8,5,5060,6,9
08e32492,135005,140425,2,8,5420,6,9
02ccec22,135005,140785,2,2,5780,6,9
08a595b2,135005,141505,2,8,6500,6,9
00fb6658,337035,337515,8,0,480,6,9
00119794,337225,337945,4,0,720,6,9
06ae2b55,337115,338305,5,6,1190,6,9
051ff448,337315,338695,8,5,1380,6,9
08e94df5,337205,339145,5,8,1940,6,9
0890b2a4,539105,539555,4,8,450,6,9
036adab1,539125,540005,1,3,880,6,9
07535242,1055,1475,2,7,420,16,9
0495e813,12065,12565,6,4,500,16,9
047cd0d6,12445,12925,7,4,480,16,9
043e3011,12385,13285,8,4,900,16,9
04284652,12315,13655,1,4,1340,16,9
044d6095,12125,14015,2,4,1890,16,9
04f998d4,12225,14375,3,4,2150,16,9
04056636,12195,15095,5,4,2900,16,9
04dcd3d8,12575,15455,6,4,2880,16,9
04752121,12375,15865,1,4,3490,16,9
04457ed6,12675,16225,2,4,3550,16,9
04df78c8,12725,16615,5,4,3890,16,9
04de9f96,12765,16975,6,4,4210,16,9
02724c67,23035,23415,7,2,380,16,9
00696ce7,23425,23925,7,0,500,16,9
05a4ec57,23545,24435,7,5,890,16,9
078495c4,34025,34565,6,7,540,16,9
05e28bd3,34115,35295,0,5,1180,16,9
07fdd6b3,34925,35655,1,7,730,16,9
0062ad57,35005,36015,2,0,1010,16,9
05449235,35175,36375,3,5,1200,16,9
07726652,34215,36735,4,7,2520,16,9
0250deb2,35845,37095,5,2,1250,16,9
05845aa3,34565,37455,6,5,2890,16,9
0103e960,34675,37815,7,1,3140,16,9
04572cf2,35165,38175,8,4,3010,16,9
039650a5,35185,38535,0,3,3350,16,9
0014c3c6,35295,38895,1,0,3600,16,9
05e618a5,35475,39255,2,5,3780,16,9
062554f8,36305,39615,3,6,3310,16,9
02241856,36245,39975,4,2,3730,16,9
06c603b2,36385,40335,5,6,3950,16,9
013327e2,36525,41055,7,1,4530,16,9
01a4b155,36595,41415,8,1,4820,16,9
077a6fd4,135005,135385,4,7,380,16,9
06737967,135005,135745,7,6,740,16,9
02307623,135005,136465,3,2,1460,16,9
08ccec25,135005,136825,5,8,1820,16,9
01563583,135005,137185,3,1,2180,16,9
02fc1295,135005,137545,5,2,2540,16,9
02eed562,135005,137905,2,2,2900,16,9
01000b95,135005,138625,5,1,3620,16,9
03409177,135005,138985,7,3,3980,16,9
01efda95,135005,139345,5,1,4340,16,9
032ae3f8,135005,140065,8,3,5060,16,9
0491ae67,135005,140425,7,4,5420,16,9
01f72fd7,135005,140785,7,1,5780,16,9
000b7d98,135005,141145,8,0,6140,16,9
047e4081,135005,141505,1,4,6500,16,9
05bddb62,337055,338255,2,5,1200,16,9
07295b98,337165,338705,8,7,1540,16,9
0369ab47,539025,539405,7,3,380,16,9
01521320,539335,539775,0,1,440,16,9
08fcd843,539495,540635,3,8,1140,16,9
015a98e4,539845,540995,4,1,1150,16,9
03b6afb6,539885,541365,6,3,1480,16,9
0295e810,12105,12485,0,2,380,6,4
0297b0d1,12185,12845,1,2,660,6,4
02056631,12155,13565,3,2,1410,6,4
02284651,12215,14315,3,2,2100,6,4
02752123,23105,23545,3,2,440,6,4
013e3013,23145,23955,3,1,810,6,4
01dcd3d3,34175,34815,3,1,640,6,4
023f1761,34125,35175,0,2,1050,6,4
03457ed1,34245,35535,1,3,1290,6,4
03de9f90,34345,35895,2,3,1550,6,4
02696ce3,34775,36255,3,2,1480,6,4
02f62631,35145,36615,0,2,1470,6,4
00a4ec50,34875,36975,1,0,2100,6,4
02845aa1,35345,37695,3,2,2350,6,4
02f62631,35145,38055,0,2,2910,6,4
00a4ec50,34875,38415,1,0,3540,6,4
038bdf23,135005,135745,3,3,740,6,4
0250deb2,135005,136105,2,2,1100,6,4
0379a0b2,135005,136465,2,3,1460,6,4
01307623,135005,136825,3,1,1820,6,4
020f3780,135005,137185,0,2,2180,6,4
02502bc2,135005,137545,2,2,2540,6,4
00c603b2,135005,137905,2,0,2900,6,4
024569f0,337075,337515,0,2,440,6,4
02bc05b1,337185,337875,1,2,690,6,4
00e32491,438165,438615,1,0,450,6,4
0233ed03,438215,438985,3,2,770,6,4
007edc82,539395,539795,2,0,400,6,4
02d7f0c0,539275,540165,0,2,890,6,4
01056635,12225,12855,4,1,630,7,6
0197b0d0,12325,13215,5,1,890,7,6
014d6095,12135,13575,0,1,1440,7,6
01284652,12395,13985,4,1,1590,7,6
01f998d0,12385,14355,0,1,1970,7,6
04752125,23085,23545,5,4,460,7,6
02457ed5,23335,23995,5,2,660,7,6
02df78c4,34085,34465,1,2,380,7,6
01272771,34415,34825,2,1,410,7,6
01784c53,34225,35185,3,1,960,7,6
0007ae82,34815,35545,4,0,730,7,6
04de9f90,34115,35905,5,4,1790,7,6
033d2aa3,34315,36625,1,3,2310,7,6
00fe91d2,35855,36985,2,0,1130,7,6
00726654,35045,37345,3,0,2300,7,6
003b8133,35485,37705,4,0,2220,7,6
04845aa3,35275,38065,5,4,2790,7,6
04e618a2,36095,38425,0,4,2330,7,6
034b3415,36185,38785,1,3,2600,7,6
0074a023,35795,39155,3,0,3360,7,6
0362ad50,35715,39515,4,3,3800,7,6
04e618a2,36095,39885,0,4,3790,7,6
05e37895,135005,135385,5,5,380,7,6
02ccec23,135005,135745,3,2,740,7,6
009e7393,135005,136105,3,0,1100,7,6
026333a0,135005,136825,0,2,1820,7,6
031559f0,135005,137185,0,3,2180,7,6
0212f964,135005,137545,4,2,2540,7,6
005007e3,135005,137905,3,0,2900,7,6
00a595b1,135005,138265,1,0,3260,7,6
052554f4,135005,138625,4,5,3620,7,6
05307623,135005,138985,3,5,3980,7,6
03d945c0,135005,139345,0,3,4340,7,6
00563584,337075,337555,4,0,480,7,6
02a0c8e5,337245,337915,5,2,670,7,6
01f38862,337165,338305,2,1,1140,7,6
00599fa4,337345,338675,4,0,1330,7,6
05dbc262,337435,339085,2,5,1650,7,6
03bb4a35,438065,438515,5,3,450,7,6
059a82f1,438155,438885,1,5,730,7,6
02292b33,438225,439255,3,2,1030,7,6
018565f0,539095,539565,0,1,470,7,6
0a535249,1075,1575,9,10,500,6,13
0195e817,12085,12485,4,1,400,6,13
014d609b,12175,12915,9,1,740,6,13
0105663b,12265,13305,12,1,1040,6,13
0197b0d9,23105,23585,9,1,480,6,13
0b3e3011,34075,34645,12,11,570,6,13
047cd0d4,34155,35725,2,4,1570,6,13
023f1760,34255,36085,3,2,1830,6,13
01df78c9,34445,36445,4,1,2000,6,13
073d2aa5,34725,36805,5,7,2080,6,13
09dcd3d6,34265,37165,6,9,2900,6,13
00b582d1,35175,37525,7,0,2350,6,13
053870a3,35305,37895,9,5,2590,6,13
0603e965,35525,38255,10,6,2730,6,13
01724c63,34565,38615,11,1,4050,6,13
02457ed6,34355,38975,12,2,4620,6,13
07b22803,35335,39705,2,7,4370,6,13
02845aa5,35435,40065,3,2,4630,6,13
08449230,36105,40425,4,8,4320,6,13
07572cf8,36075,40785,5,7,4710,6,13
049650a6,36135,41145,6,4,5010,6,13
0230aca7,36195,41505,7,2,5310,6,13
098bdf20,36305,41895,10,9,5590,6,13
0be618a4,36355,42615,12,11,6260,6,13
0c14c3c3,36215,42975,0,12,6760,6,13
084b3410,36405,43345,2,8,6940,6,13
031ff443,135005,135385,3,3,380,6,13
09a1289c,135005,135745,12,9,740,6,13
0bfdd2a1,135005,136105,1,11,1100,6,13
076333ac,135005,136465,12,7,1460,6,13
0b5fb4c1,135005,136825,1,11,1820,6,13
08d945c5,135005,137185,5,8,2180,6,13
027fc510,135005,137545,0,2,2540,6,13
002ed3d6,135005,137905,6,0,2900,6,13
08bf6d31,135005,138265,1,8,3260,6,13
0bcaf2a6,135005,138625,6,11,3620,6,13
05dbc264,135005,138985,4,5,3980,6,13
0490d44b,135005,139345,11,4,4340,6,13
032e2eda,135005,139705,10,3,4700,6,13
02fcf0e7,135005,140065,7,2,5060,6,13
06513ae4,135005,140425,4,6,5420,6,13
022554f8,135005,140785,8,2,5780,6,13
07d60b76,135005,141505,6,7,6500,6,13
0633ed08,135005,141865,8,6,6860,6,13
047edc8b,135005,142225,11,4,7220,6,13
039e7394,135005,142585,4,3,7580,6,13
0bb4b498,135005,142945,8,11,7940,6,13
06ff29c4,135005,143305,4,6,8300,6,13
02292b32,135005,143665,2,2,8660,6,13
098db5a9,135005,144025,9,9,9020,6,13
0ae94df6,135005,144385,6,10,9380,6,13
049e94eb,337045,337905,11,4,860,6,13
00fb9b63,539255,539825,3,0,570,6,13
05bc4b8b,539415,540315,11,5,900,6,13
0153524d,1065,1455,13,1,390,15,14
034d6096,12135,12525,2,3,390,15,14
0395e816,12065,12895,4,3,830,15,14
0328465d,12305,13305,8,3,1000,15,14
0375212d,12315,13695,11,3,1380,15,14
03f998d8,12285,14085,0,3,1800,15,14
0305663b,12225,14445,1,3,2220,15,14
083e301d,23045,23465,13,8,420,15,14
0427277d,23455,24075,13,4,620,15,14
0b2d612c,34035,34485,0,11,450,15,14
038495cc,34335,34845,1,3,510,15,14
05b22801,34585,35215,3,5,630,15,14
0be28bda,34355,35575,4,11,1220,15,14
03cdb8f1,34095,35935,5,3,1840,15,14
017d6538,35025,36295,6,1,1270,15,14
04726652,34375,36655,7,4,2280,15,14
04a4ec50,34285,37015,8,4,2730,15,14
0c069f2d,34135,37385,10,12,3250,15,14
0207ae8d,34265,37745,11,2,3480,15,14
0042120d,34675,38105,12,0,3430,15,14
0c3870ab,34485,38475,0,12,3990,15,14
0062ad56,35175,38845,2,0,3670,15,14
0903e967,34855,39215,4,9,4360,15,14
02f62632,34415,39575,5,2,5160,15,14
09845aab,34725,39965,8,9,5240,15,14
01b582d4,34365,40335,10,1,5970,15,14
02fdd6b3,35115,40705,12,2,5590,15,14
093b8139,34955,41075,0,9,6120,15,14
06ab35e2,135005,135385,2,6,380,15,14
0dd80dbd,135005,135745,13,13,740,15,14
0527b4b5,135005,136105,5,5,1100,15,14
00de6385,135005,136465,5,0,1460,15,14
00df5faa,135005,136825,10,0,1820,15,14
0963eaea,135005,137185,10,9,2180,15,14
05bf9c63,135005,137545,3,5,2540,15,14
005fb4ca,135005,137905,10,0,2900,15,14
04ccec2c,135005,138265,12,4,3260,15,14
0dcaf2a4,135005,138625,4,13,3620,15,14
0191ae67,135005,138985,7,1,3980,15,14
05ebc9a5,135005,139345,5,5,4340,15,14
00b69db7,135005,139705,7,0,4700,15,14
083ff78a,135005,140425,10,8,5420,15,14
0c574c56,135005,140785,6,12,5780,15,14
055f48d2,135005,141145,2,5,6140,15,14
02b3b7fb,135005,141505,11,2,6500,15,14
0483dc99,135005,141865,9,4,6860,15,14
0a50deb9,135005,142225,9,10,7220,15,14
04c4bd96,135005,142585,6,4,7580,15,14
0112f969,135005,142945,9,1,7940,15,14
04b4b494,135005,143305,4,4,8300,15,14
018fdf73,135005,143665,3,1,8660,15,14
01fcf0e1,135005,144025,1,1,9020,15,14
08f2c04a,135005,144385,10,8,9380,15,14
0d18d881,135005,144745,1,13,9740,15,14
02dbf6b1,337095,337655,1,2,560,15,14
02e45923,337395,338025,3,2,630,15,14
0afb4ae4,337225,338385,4,10,1160,15,14
063819b5,337315,338745,5,6,1430,15,14
035e7886,337155,339105,6,3,1950,15,14
064df28b,337495,339535,11,6,2040,15,14
093050dd,337795,339905,13,9,2110,15,14
01cf61e3,337695,340315,3,1,2620,15,14
079b0c24,337625,340675,4,7,3050,15,14
01e1bd16,438185,438955,6,1,770,15,14
044f9d88,438485,439325,8,4,840,15,14
0cfe953b,438565,439715,11,12,1150,15,14
0996256c,438665,440075,12,9,1410,15,14
04c03732,438935,440485,2,4,1550,15,14
046fae26,438825,441235,6,4,2410,15,14
0b0b4d88,439035,441605,8,11,2570,15,14
063e204c,438885,442015,12,6,3130,15,14
06e4d121,539075,539735,1,6,660,15,14
01535244,1075,1515,4,1,440,11,9
0695e810,12055,12485,2,6,430,11,9
06284657,12325,12845,3,6,520,11,9
064d6091,12065,13205,4,6,1140,11,9
0697b0d4,12195,13595,7,6,1400,11,9
06f998d5,12275,13985,1,6,1710,11,9
06056635,12155,14345,2,6,2190,11,9
06752122,12415,14775,7,6,2360,11,9
073e3013,23025,23505,3,7,480,11,9
07de9f93,23515,24015,3,7,500,11,9
05ff7e53,23865,24525,3,5,660,11,9
072d6120,34105,34895,6,7,790,11,9
0007ae80,34385,35255,7,0,870,11,9
07c380d3,35065,35615,8,7,550,11,9
02cdb8f1,34155,35975,0,2,1820,11,9
058495c7,34565,36695,2,5,2130,11,9
0503e962,34995,37055,3,5,2060,11,9
07ccc9d7,34915,37415,4,7,2500,11,9
08421204,34865,38145,7,8,3280,11,9
027d6534,35155,38505,8,2,3350,11,9
03fdd6b7,35245,38865,0,3,3620,11,9
06fe91d1,35495,39225,1,6,3730,11,9
0163eae7,35415,39595,3,1,4180,11,9
083b8135,35045,39965,5,8,4920,11,9
0262ad50,35335,40335,7,2,5000,11,9
049a82f3,135005,135385,3,4,380,11,9
03fb6658,135005,135745,8,3,740,11,9
06f72fd2,135005,136105,2,6,1100,11,9
04449236,135005,136465,6,4,1460,11,9
00265b67,135005,136825,7,0,1820,11,9
053327e6,135005,137185,6,5,2180,11,9
04d945c1,135005,137545,1,4,2540,11,9
0625a774,135005,137905,4,6,2900,11,9
08b4b491,135005,138265,1,8,3260,11,9
042e2ed8,135005,138625,8,4,3620,11,9
06daddc3,135005,138985,3,6,3980,11,9
06a12891,135005,139705,1,6,4700,11,9
00d60b76,135005,140425,6,0,5420,11,9
08ccec26,135005,140785,6,8,5780,11,9
07488783,135005,141145,3,7,6140,11,9
08617732,135005,141505,2,8,6500,11,9
00b69db3,337085,337595,3,0,510,11,9
05b49ca4,337375,337955,4,5,580,11,9
02cde4d5,337185,338315,5,2,1130,11,9
040b7d96,337225,338675,6,4,1450,11,9
06371958,337505,339045,8,6,1540,11,9
0272db60,337435,339405,0,2,1970,11,9
024266d1,337255,339765,1,2,2510,11,9
0649b043,337595,340135,3,6,2540,11,9
055e2766,337355,340525,6,5,3170,11,9
0771a460,337585,340915,0,7,3330,11,9
01807697,438135,438535,7,1,400,11,9
08261f70,438045,438905,0,8,860,11,9
03cd9280,539155,539685,0,3,530,11,9
03535241,1045,1475,1,3,430,15,5
0395e812,12015,12465,0,3,450,15,5
034d6093,12045,12825,1,3,780,15,5
03056633,12115,13185,2,3,1070,15,5
03284654,12195,13905,4,3,1710,15,5
0397b0d3,12165,14265,0,3,2100,15,5
03752122,12215,14625,1,3,2410,15,5
033e3014,12275,15015,4,3,2740,15,5
01ff7e54,23555,23975,4,1,420,15,5
02272774,23605,24405,4,2,800,15,5
002d6122,34035,34445,4,0,410,15,5
02cdb8f3,34045,34805,0,2,760,15,5
03e28bd3,34285,35165,1,3,880,15,5
048495c1,34235,35525,2,4,1290,15,5
00069f23,34105,35885,3,0,1780,15,5
02845aa0,34685,36605,0,2,1920,15,5
00f62634,34495,36975,2,0,2480,15,5
043b8133,34825,37335,3,4,2510,15,5
0003e963,34815,37695,4,0,2880,15,5
040f3780,135005,135385,0,4,380,15,5
01a4b152,135005,135745,2,1,740,15,5
00ec0d70,135005,136105,0,0,1100,15,5
02488784,135005,136465,4,2,1460,15,5
046333a0,135005,137185,0,4,2180,15,5
04e32494,135005,137545,4,4,2540,15,5
00bf6d32,135005,137905,2,0,2900,15,5
019a82f2,135005,138265,2,1,3260,15,5
014b3413,135005,138625,3,1,3620,15,5
018db5a3,337105,337515,3,1,410,15,5
02fb6654,337375,337875,4,2,500,15,5
0436cda2,337275,338605,2,4,1330,15,5
02119793,337505,338965,3,2,1460,15,5
016adab4,438245,438675,4,1,430,15,5
03ebc9a0,438385,439035,0,3,650,15,5
00fcf0e2,438295,439405,2,0,1110,15,5
04daddc3,438355,439765,3,4,1410,15,5
0165d932,539705,540105,2,1,400,15,5
024bf943,539645,540465,3,2,820,15,5
001340a1,539335,541195,1,0,1860,15,5
05535242,1005,1515,2,5,510,9,14
074d609c,12135,12605,6,7,470,9,14
0795e81b,12065,12975,8,7,910,9,14
07056633,12235,13425,0,7,1190,9,14
0697b0dc,23055,23445,12,6,390,9,14
00f998dc,23105,24055,12,0,950,9,14
0b284653,34095,34525,2,11,430,9,14
09752121,34155,34885,3,9,730,9,14
03dcd3d1,34325,35245,4,3,920,9,14
023e3015,34165,35605,5,2,1440,9,14
04e28bd5,35055,35965,6,4,910,9,14
027cd0db,34185,36325,7,2,2140,9,14
02696ce5,34845,36685,8,2,1840,9,14
080f3789,36485,37045,9,8,560,9,14
098bdf26,36205,37405,10,9,1200,9,14
023f1763,34255,37765,11,2,3510,9,14
038495c2,34975,38125,12,3,3150,9,14
00df78cc,34405,38485,13,0,4080,9,14
03de9f93,34425,38845,0,3,4420,9,14
00724c69,34525,39205,1,0,4680,9,14
06457ed3,34395,39565,2,6,5170,9,14
0674a023,35905,39925,3,6,4020,9,14
01a4ec56,34965,40285,4,1,5320,9,14
0907ae86,34935,40645,5,9,5710,9,14
02c380d9,35615,41005,6,2,5390,9,14
0514c3c7,36165,41365,7,5,5200,9,14
044b3415,36385,41725,8,4,5340,9,14
04265b63,36695,42085,9,4,5390,9,14
01421205,35275,42495,13,1,7220,9,14
09845aab,35305,43215,1,9,7910,9,14
04241850,37075,43575,2,4,6500,9,14
0bbf9c66,36775,43935,3,11,7160,9,14
00449236,36055,44295,4,0,8240,9,14
0c63eae3,35925,44655,5,12,8730,9,14
05513ae5,36865,45015,6,5,8150,9,14
0d79a0b3,37035,45375,7,13,8340,9,14
007be714,37065,45735,8,0,8670,9,14
010b7d9d,135005,135385,13,1,380,9,14
06807694,135005,135745,4,6,740,9,14
007a6fd9,135005,136105,9,0,1100,9,14
06199ba2,135005,136465,2,6,1460,9,14
0259f26c,135005,136825,12,2,1820,9,14
0aa4b155,135005,137185,5,10,2180,9,14
044569f2,135005,137545,2,4,2540,9,14
08d7f0cd,135005,137905,13,8,2900,9,14
0a28f1f2,135005,138265,2,10,3260,9,14
0bf38869,135005,138625,9,11,3620,9,14
088565fb,135005,138985,11,8,3980,9,14
08fb6653,135005,139345,3,8,4340,9,14
03daddc2,135005,139705,2,3,4700,9,14
01e8a383,135005,140065,3,1,5060,9,14
0249b047,135005,140425,7,2,5420,9,14
077e4081,135005,140785,1,7,5780,9,14
005c470b,135005,141145,11,0,6140,9,14
03737962,135005,141505,2,3,6500,9,14
03d80db4,135005,141865,4,3,6860,9,14
05da9f8d,135005,142225,13,5,7220,9,14
057fc515,135005,142585,5,5,7580,9,14
015816d3,135005,142945,3,1,7940,9,14
07caf2a8,135005,143305,8,7,8300,9,14
029a82f0,135005,143665,0,2,8660,9,14
0a2e2ed3,135005,144025,3,10,9020,9,14
036adabc,135005,144385,12,3,9380,9,14
061340ad,135005,144745,13,6,9740,9,14
09b69db3,135005,145105,3,9,10100,9,14
0bc59f59,337085,337535,9,11,450,9,14
0a39650b,337035,337905,11,10,870,9,14
08488350,337175,338295,0,8,1120,9,14
01175c18,337245,338785,8,1,1540,9,14
05574c54,438085,438515,4,5,430,9,14
041b4989,438135,438945,9,4,810,9,14
08c42736,539115,539585,6,8,470,9,14
07535246,1095,1575,6,7,480,4,11
0795e811,12075,12545,4,7,470,4,11
014d6094,23055,23545,4,1,490,4,11
0297b0d3,34145,34525,3,2,380,4,11
047cd0d8,34465,34915,6,4,450,4,11
013f1764,34555,35275,7,1,720,4,11
09056631,34095,35635,8,9,1540,4,11
0a457ed1,34575,35995,9,10,1420,4,11
06b22800,35745,36355,10,6,610,4,11
0707ae84,35255,36715,0,7,1460,4,11
073e3015,34405,37075,1,7,2670,4,11
088495c5,35435,37435,2,8,2000,4,11
04f998d2,34245,37795,3,4,3550,4,11
08dcd3d3,34565,38155,4,8,3590,4,11
03df78c5,34585,38515,5,3,3930,4,11
08a4ec57,35345,38885,7,8,3540,4,11
0ade9f98,34645,39245,8,10,4600,4,11
0a03e962,35975,39605,9,10,3630,4,11
07ccc9d0,35875,39965,10,7,4090,4,11
047d6534,36085,40335,1,4,4250,4,11
06845aa7,35795,41065,4,6,5270,4,11
04696ce2,35175,41425,5,4,6250,4,11
02c380d5,36055,41795,7,2,5740,4,11
01fdd6b9,36125,42165,9,1,6040,4,11
0999bf19,135005,135385,9,9,380,4,11
011559fa,135005,135745,10,1,740,4,11
0a4569fa,135005,136105,10,10,1100,4,11
08e32496,135005,136465,6,8,1460,4,11
0474a029,135005,136825,9,4,1820,4,11
02449231,135005,137185,1,2,2180,4,11
058bdf27,135005,137545,7,5,2540,4,11
080f3782,135005,137905,2,8,2900,4,11
03bf9c62,135005,138265,2,3,3260,4,11
0879a0b0,135005,138625,0,8,3620,4,11
01c603b0,135005,138985,0,1,3980,4,11
05ccec28,337095,337515,8,5,420,4,11
097edc8a,337135,337885,10,9,750,4,11
0925a77a,337235,338435,10,9,1200,4,11
052ed3d8,438045,438555,8,5,510,4,11
05cdb129,438135,438915,9,5,780,4,11
055007e6,539055,539525,6,5,470,4,11
0a53524c,1065,1555,12,10,490,2,16
0595e81f,12025,12665,1,5,640,2,16
054d609b,23105,23545,11,5,440,2,16
0805663b,23175,24195,11,8,1020,2,16
0897b0d4,34075,34505,9,8,430,2,16
007cd0d7,34465,34895,12,0,430,2,16
08752125,34365,35265,14,8,900,2,16
08f998d5,34165,35625,15,8,1460,2,16
05de9f9e,34855,35985,0,5,1130,2,16
00e28bde,35345,36345,1,0,1000,2,16
0a3d2aa8,34975,36705,2,10,1730,2,16
0a457ede,34675,37065,3,10,2390,2,16
0727277f,35015,37425,4,7,2410,2,16
043e3018,34405,37785,5,4,3380,2,16
0730acae,36535,38145,6,7,1610,2,16
01df78cf,34755,38505,7,1,3750,2,16
0edcd3d0,34595,39585,10,14,4990,2,16
09726654,35455,39945,11,9,4490,2,16
062d6124,35025,40305,12,6,5280,2,16
03ff7e54,35005,40665,13,3,5660,2,16
03cdb8f1,35045,41025,14,3,5980,2,16
0a3f1765,34545,41385,15,10,6840,2,16
0f62ad51,36165,41745,0,15,5580,2,16
0c449231,36425,42105,1,12,5680,2,16
0f069f22,35085,42465,2,15,7380,2,16
0f63eaec,36245,42825,3,15,6580,2,16
0c8495cc,35255,43185,4,12,7930,2,16
00a4ec56,35195,43545,5,0,8350,2,16
00b34d85,36825,43905,6,0,7080,2,16
0303e96f,35935,44265,7,3,8330,2,16
0107ae8b,35175,44625,8,1,9450,2,16
04fdd2a6,37305,45705,11,4,8400,2,16
062d6124,35025,46065,12,6,11040,2,16
08b582d2,35395,46425,13,8,11030,2,16
03cdb8f1,35045,46785,14,3,11740,2,16
0a3f1765,34545,47145,15,10,12600,2,16
0f62ad51,36165,47505,0,15,11340,2,16
05a4b158,135005,135385,8,5,380,2,16
01c4bd9a,135005,135745,10,1,740,2,16
0f5fb4c3,135005,136105,3,15,1100,2,16
029a18f4,135005,136465,4,2,1460,2,16
0ad60b75,135005,136825,5,10,1820,2,16
0ad945c8,135005,137185,8,10,2180,2,16
01e3789f,135005,137545,15,1,2540,2,16
0733ed0d,135005,137905,13,7,2900,2,16
047fc51c,135005,138265,12,4,3260,2,16
09d7f0c0,135005,138625,0,9,3620,2,16
087edc86,135005,138985,6,8,3980,2,16
052ed3d0,135005,139345,0,5,4340,2,16
025007e6,135005,139705,6,2,4700,2,16
0a7be716,135005,140065,6,10,5060,2,16
0e2554f0,135005,140425,0,14,5420,2,16
0a6333aa,135005,140785,10,10,5780,2,16
059e7394,337015,337435,4,5,420,2,16
0128f1f5,337055,337795,5,1,740,2,16
0abf6d38,539075,539585,8,10,510,2,16
01535248,1065,1555,8,1,490,7,13
0c95e814,12095,12545,7,12,450,7,13
0c4d6095,12195,13095,5,12,900,7,13
0505663b,23015,23625,11,5,610,7,13
0128465b,23125,24215,11,1,1090,7,13
01752127,34015,34465,3,1,450,7,13
02457eda,34255,34855,6,2,600,7,13
03dcd3d9,34245,35215,7,3,970,7,13
00272777,34595,35575,8,0,980,7,13
07de9f94,34295,36295,10,7,2000,7,13
0562ad52,35945,36655,11,5,710,7,13
027cd0d9,34175,37015,12,2,2840,7,13
033f176b,34195,37375,0,3,3180,7,13
0a696ce0,34765,37735,1,10,2970,7,13
042d612b,34665,38095,2,4,3430,7,13
00784c56,34405,38455,3,0,4050,7,13
023d2aac,34505,38815,4,2,4310,7,13
03726651,35025,39175,5,3,4150,7,13
0cccc9d5,35545,39535,6,12,3990,7,13
03724c67,34355,39895,7,3,5540,7,13
043870a3,35175,40615,9,4,5440,7,13
00cdb8fc,34675,40975,10,0,6300,7,13
084b3413,36485,41335,11,8,4850,7,13
0979a0b1,36845,41695,12,9,4850,7,13
0ce618a2,36445,42055,0,12,5610,7,13
08c603b9,37035,42415,1,8,5380,7,13
0a513ae1,36695,42775,2,10,6080,7,13
058bdf20,36435,43135,3,5,6700,7,13
05c380d3,35675,43495,4,5,7820,7,13
086333a3,37065,43855,5,8,6790,7,13
0a50deb2,36605,44215,6,10,7610,7,13
013327e5,37135,44575,7,1,7440,7,13
06fdd2a6,36775,44935,8,6,8160,7,13
0a502bc3,36735,45295,9,10,8560,7,13
0072db69,135005,135385,9,0,380,7,13
0799bf16,135005,135745,6,7,740,7,13
0bd60b78,135005,136105,8,11,1100,7,13
01ec0d7c,135005,136465,12,1,1460,7,13
022ed3dc,135005,136825,12,2,1820,7,13
0592f851,135005,137185,1,5,2180,7,13
01f3886c,135005,137545,12,1,2540,7,13
0c9a82f0,135005,137905,0,12,2900,7,13
068db5ac,135005,138265,12,6,3260,7,13
04119791,135005,138625,1,4,3620,7,13
0bebc9ac,135005,138985,12,11,3980,7,13
0a7ca597,135005,139705,7,10,4700,7,13
04807697,135005,140065,7,4,5060,7,13
039a18f4,135005,140425,4,3,5420,7,13
07e32493,135005,140785,3,7,5780,7,13
0a7edc86,135005,141145,6,10,6140,7,13
0528f1f8,135005,141505,8,5,6500,7,13
08caf2ac,135005,141865,12,8,6860,7,13
0a61773a,135005,142225,10,10,7220,7,13
06ae2b56,135005,142945,6,6,7940,7,13
00fcf0e1,135005,143305,1,0,8300,7,13
0b976677,135005,143665,7,11,8660,7,13
0265d939,135005,144025,9,2,9020,7,13
0c5e2764,135005,144385,4,12,9380,7,13
0a0042d0,337195,337615,0,10,420,7,13
08530c75,337205,338375,5,8,1170,7,13
057e4088,337285,338765,8,5,1480,7,13
0cc9c2ea,337265,339135,10,12,1870,7,13
041451cc,337305,339505,12,4,2200,7,13
087a6fd4,539025,539465,4,8,440,7,13
0b535242,1055,1595,2,11,540,12,12
0195e817,12045,12425,5,1,380,12,12
0105663a,12145,12895,0,1,750,12,12
014d6090,12075,13265,2,1,1190,12,12
0197b0d7,12225,13625,3,1,1400,12,12
06f998d5,23025,23425,5,6,400,12,12
063f1765,23385,23995,5,6,610,12,12
08724c64,34025,34585,1,8,560,12,12
05cdb8f8,34445,34975,4,5,530,12,12
09ff7e5a,34225,35335,5,9,1110,12,12
00784c58,34105,35705,7,0,1600,12,12
0727277b,34305,36075,9,7,1770,12,12
03069f2a,34475,36435,10,3,1960,12,12
0a8495c3,34715,36805,0,10,2090,12,12
00696ce2,34575,37175,2,0,2600,12,12
03a4ec55,34655,37565,5,3,2910,12,12
0107ae81,34645,37975,9,1,3330,12,12
08241850,135005,135385,0,8,380,12,12
07da9f80,135005,135745,0,7,740,12,12
01ccec25,135005,136105,5,1,1100,12,12
0ba595b4,135005,136465,4,11,1460,12,12
089a82f2,135005,136825,2,8,1820,12,12
06ae2b58,135005,137185,8,6,2180,12,12
05eed563,135005,137545,3,5,2540,12,12
00b69db4,135005,137905,4,0,2900,12,12
00ebab41,135005,138265,1,0,3260,12,12
07b582d8,135005,138625,8,7,3620,12,12
07fdd6b7,135005,138985,7,7,3980,12,12
054b3415,135005,139345,5,5,4340,12,12
071559f3,135005,139705,3,7,4700,12,12
0812f965,135005,140065,5,8,5060,12,12
0392f851,135005,140425,1,3,5420,12,12
0a61773a,135005,140785,10,10,5780,12,12
0636cdaa,135005,141145,10,6,6140,12,12
04f72fd0,135005,141505,0,4,6500,12,12
05f2c04a,135005,141865,10,5,6860,12,12
07261f74,135005,142225,4,7,7220,12,12
067901c2,135005,142585,2,6,7580,12,12
0ac380d8,135005,142945,8,10,7940,12,12
088bdf2a,135005,143305,10,8,8300,12,12
01779fa0,337225,337605,0,1,380,12,12
06199ba2,337075,337975,2,6,900,12,12
0ae05d57,337265,338735,7,10,1470,12,12
04761372,438165,438555,2,4,390,12,12
0559f263,438235,438915,3,5,680,12,12
0b921c04,438205,439275,4,11,1070,12,12
08737967,438195,439665,7,8,1470,12,12
0b61ab63,539015,539395,3,11,380,12,12
03cee614,539555,539985,4,3,430,12,12
023ff785,539255,540345,5,2,1090,12,12
00d80dba,539295,540775,10,0,1480,12,12
0753524e,1025,1535,14,7,510,12,15
0795e815,12085,12625,3,7,540,12,15
074d609c,12135,12985,4,7,850,12,15
07056639,12175,13735,8,7,1560,12,15
0797b0dd,12235,14125,11,7,1890,12,15
0728465a,12325,14485,12,7,2160,12,15
07f998da,12255,14955,4,7,2700,12,15
003e3015,23075,23665,5,0,590,12,15
0a3f176d,34055,34545,14,10,490,12,15
0b3d2aac,34525,34935,2,11,410,12,15
04dcd3d3,34065,35295,3,4,1230,12,15
00724c65,34395,35655,4,0,1260,12,15
09784c5c,34445,36025,6,9,1580,12,15
03de9f93,34295,36455,11,3,2160,12,15
00df78c0,34205,36815,12,0,2610,12,15
052d612a,34645,37225,1,5,2580,12,15
0d069f2c,34755,37585,2,13,2830,12,15
0d07ae84,34945,37945,3,13,3000,12,15
01696cee,34855,38335,6,1,3480,12,15
09a4ec50,34985,38865,1,9,3880,12,15
08488783,135005,135385,3,8,380,12,15
02bb4a3d,135005,135745,13,2,740,12,15
0a102c37,135005,136465,7,10,1460,12,15
057ca591,135005,136825,1,5,1820,12,15
0e807699,135005,137185,9,14,2180,12,15
04567863,135005,137545,3,4,2540,12,15
01d2b798,135005,138265,8,1,3260,12,15
05e28bde,135005,138625,14,5,3620,12,15
037d653e,135005,138985,14,3,3980,12,15
06e618ad,135005,139345,13,6,4340,12,15
017be710,135005,139705,0,1,4700,12,15
0d9a18f9,135005,140065,9,13,5060,12,15
00d7f0ce,135005,140425,14,0,5420,12,15
0bdbc26a,135005,140785,10,11,5780,12,15
0d2e2ed8,135005,141145,8,13,6140,12,15
03ebc9a3,135005,141505,3,3,6500,12,15
0865d933,135005,141865,3,8,6860,12,15
0e49b04d,135005,142225,13,14,7220,12,15
03e07297,135005,142585,7,3,7580,12,15
004f61aa,135005,142945,10,0,7940,12,15
06d80db1,135005,143305,1,6,8300,12,15
07175c12,135005,143665,2,7,8660,12,15
063b8139,135005,144025,9,6,9020,12,15
0814c3c4,135005,144385,4,8,9380,12,15
04fdd2a3,135005,144745,3,4,9740,12,15
0a5fb4c5,135005,145105,5,10,10100,12,15
057fc510,135005,145465,0,5,10460,12,15
0dbf6d34,135005,145825,4,13,10820,12,15
020168a6,337035,337475,6,2,440,12,15
062e6ece,337015,337965,14,6,950,12,15
048d14e3,438035,438445,3,4,410,12,15
07b80a8c,438095,438955,12,7,860,12,15
03fb52a2,539295,539685,2,3,390,12,15
036c09f7,539255,540115,7,3,860,12,15
06535247,1085,1535,7,6,450,5,13
0c4d6092,12065,12525,6,12,460,5,13
0c95e817,12025,12895,8,12,870,5,13
0c056636,12095,13265,10,12,1170,5,13
0497b0d5,23065,23505,5,4,440,5,13
073e3015,23235,24095,5,7,860,5,13
047cd0dc,34075,34525,6,4,450,5,13
0cdf78c6,34215,34885,7,12,670,5,13
01069f2b,34545,35245,8,1,700,5,13
05cdb8f2,34505,35605,9,5,1100,5,13
07724c67,34305,35965,10,7,1660,5,13
02b582db,34885,36325,11,2,1440,5,13
04e28bd2,34815,36685,12,4,1870,5,13
043f176a,34175,37045,0,4,2870,5,13
0bde9f95,34295,37405,1,11,3110,5,13
0cdcd3da,34195,37765,2,12,3570,5,13
0a3d2aa4,34335,38125,3,10,3790,5,13
08457eda,34205,38485,4,8,4280,5,13
08ccc9d4,35365,38845,5,8,3480,5,13
00ff7e5c,34385,39205,6,0,4820,5,13
083870a8,35075,39565,7,8,4490,5,13
02696cec,34585,39925,8,2,5340,5,13
0aa4ec5a,34645,40285,9,10,5640,5,13
0c421207,35205,40645,10,12,5440,5,13
009650aa,36125,41005,11,0,4880,5,13
0850deb7,36695,41365,12,8,4670,5,13
08b34d85,36485,41725,0,8,5240,5,13
00e618a9,36385,42085,1,0,5700,5,13
013327e6,37325,42445,2,1,5120,5,13
07726656,34985,42815,4,7,7830,5,13
016333a7,37265,43175,5,1,5910,5,13
0463eae9,35805,43895,7,4,8090,5,13
0b99bf1b,37425,44255,8,11,6830,5,13
032554fb,37195,44615,9,3,7420,5,13
0c421207,35205,44975,10,12,9770,5,13
05513aea,36825,45335,11,5,8510,5,13
00265b69,36755,45695,12,0,8940,5,13
09daddc9,135005,135385,9,9,380,5,13
06307621,135005,135745,1,6,740,5,13
0bd60b70,135005,136105,0,11,1100,5,13
09e32498,135005,136465,8,9,1460,5,13
00d7f0cc,135005,136825,12,0,1820,5,13
08cdb125,135005,137185,5,8,2180,5,13
03bf6d35,135005,137545,5,3,2540,5,13
052ae3f7,135005,137905,7,5,2900,5,13
04ff29c4,135005,138265,4,4,3260,5,13
019a82fb,135005,138625,11,1,3620,5,13
00b36cb8,135005,138985,8,0,3980,5,13
0836cda4,135005,139345,4,8,4340,5,13
001ff445,135005,139705,5,0,4700,5,13
099a18fb,135005,140425,11,9,5420,5,13
06bc05b7,135005,140785,7,6,5780,5,13
037fc51b,135005,141145,11,3,6140,5,13
0525a776,135005,141505,6,5,6500,5,13
089e7392,135005,141865,2,8,6860,5,13
03f38860,135005,142585,0,3,7580,5,13
0b617736,135005,142945,6,11,7940,5,13
0590d441,135005,143305,1,5,8300,5,13
06fc1294,135005,143665,4,6,8660,5,13
03e94df7,135005,144025,7,3,9020,5,13
056adabc,135005,144385,12,5,9380,5,13
049e94e8,337075,337515,8,4,440,5,13
0197667b,337125,337905,11,1,780,5,13
00e8a381,337275,338295,1,0,1020,5,13
001340a7,337175,338745,7,0,1570,5,13
00fb9b68,337205,339105,8,0,1900,5,13
01535249,1035,1495,9,1,460,16,12
0595e811,12045,12525,10,5,480,16,12
034d6096,23085,23685,6,3,600,16,12
003f1766,23605,24255,6,0,650,16,12
06dcd3d1,34095,34525,10,6,430,16,12
05ff7e51,34335,34915,1,5,580,16,12
0bde9f90,34195,35275,2,11,1080,16,12
0b069f27,34555,35635,3,11,1080,16,12
0a457ed5,34175,36005,5,10,1830,16,12
0b724c65,34265,36365,6,11,2100,16,12
08df78c4,34185,36725,7,8,2540,16,12
02784c51,34285,37085,8,2,2800,16,12
08696ce9,34635,37445,9,8,2810,16,12
002d6127,34495,37805,10,0,3310,16,12
0af62637,35115,38525,0,10,3410,16,12
0a07ae8a,34725,38885,1,10,4160,16,12
07572cf4,36065,39245,2,7,3180,16,12
07845aa5,35405,39605,3,7,4200,16,12
08265b63,36685,39965,4,8,3280,16,12
09fe91d1,35985,40325,5,9,4340,16,12
03e618a1,36365,40685,6,3,4320,16,12
0962ad57,35755,41045,7,9,5290,16,12
09e28bd2,34885,41405,8,9,6520,16,12
03c603b0,37215,41765,9,3,4550,16,12
047be718,37085,42125,10,4,5040,16,12
04c4bd94,37495,42485,11,4,4990,16,12
0a3870a7,35205,42845,0,10,7640,16,12
0530762b,37535,43205,1,5,5670,16,12
0150deb0,36655,43565,2,1,6910,16,12
00fdd2a7,36935,43925,3,0,6990,16,12
0aa4b152,37385,44285,4,10,6900,16,12
0279a0b7,36985,44645,5,2,7660,16,12
003327e6,37335,45005,6,0,7670,16,12
015fb4c7,37545,45365,7,1,7820,16,12
0afb6652,135005,135385,2,10,380,16,12
031340a9,135005,135745,9,3,740,16,12
0956786b,135005,136465,11,9,1460,16,12
0461ab69,135005,136825,9,4,1820,16,12
02488352,135005,137185,2,2,2180,16,12
01fb52a9,135005,137545,9,1,2540,16,12
0569ab43,135005,137905,3,5,2900,16,12
0883dc99,135005,138265,9,8,3260,16,12
0a9a18f8,135005,138625,8,10,3620,16,12
0a2ed3db,135005,138985,11,10,3980,16,12
01ff29c3,135005,139345,3,1,4340,16,12
069e94e1,135005,139705,1,6,4700,16,12
07b49ca2,135005,140065,2,7,5060,16,12
00e07296,135005,140425,6,0,5420,16,12
04921c07,135005,140785,7,4,5780,16,12
06466e60,135005,141505,0,6,6500,16,12
01295b94,135005,141865,4,1,6860,16,12
0251e0b9,135005,142225,9,2,7220,16,12
063050d0,135005,142585,0,6,7580,16,12
037edc8b,135005,142945,11,3,7940,16,12
07f38865,135005,143305,5,7,8300,16,12
0a2e2ed5,135005,143665,5,10,8660,16,12
00344b84,337055,337435,4,0,380,16,12
08b85c84,438305,438745,4,8,440,16,12
0923a046,438535,439115,6,9,580,16,12
065f9a1a,438415,439525,10,6,1110,16,12
0155527b,438345,439885,11,1,1540,16,12
05d23581,438545,440255,1,5,1710,16,12
00c80963,438575,440625,3,0,2050,16,12
09c6e1f4,438465,440985,4,9,2520,16,12
0038eed4,539325,539925,4,0,600,16,12
01403ad6,539495,540295,6,1,800,16,12
0ab2b2b0,539345,540745,0,10,1400,16,12
0395e810,12035,12445,2,3,410,12,4
034d6091,12075,13165,0,3,1090,12,4
03f998d0,12255,13525,1,3,1270,12,4
037cd0d1,12415,14255,0,3,1840,12,4
03752123,12345,14615,1,3,2270,12,4
003f1762,23025,23445,2,0,420,12,4
03724c62,23215,23855,2,3,640,12,4
01784c50,34075,34485,0,1,410,12,4
022d6120,34275,34845,1,2,570,12,4
013d2aa0,34135,35205,2,1,1070,12,4
02696ce3,34395,35925,0,2,1530,12,4
00726653,34765,36285,1,0,1520,12,4
00421200,34955,36645,2,0,1690,12,4
024b3412,35855,37365,0,2,1510,12,4
00265b63,36135,37725,1,0,1590,12,4
00a4b151,36595,38085,2,0,1490,12,4
000f3780,35955,38445,3,0,2490,12,4
03fdd2a3,36325,38805,0,3,2480,12,4
00265b63,36135,39165,1,0,3030,12,4
01ff29c0,135005,135385,0,1,380,12,4
02c4bd93,135005,135745,3,2,740,12,4
0033ed02,135005,136105,2,0,1100,12,4
019e7391,135005,136465,1,1,1460,12,4
00b36cb1,135005,136825,1,0,1820,12,4
03e37893,135005,137185,3,3,2180,12,4
035007e2,135005,137545,2,3,2540,12,4
01f38860,135005,137905,0,1,2900,12,4
00ae2b53,438215,438625,3,0,410,12,4
02e94df0,438245,438985,0,2,740,12,4
03119792,438325,439355,2,3,1030,12,4
0195e811,12045,12445,5,1,400,12,7
014d6094,12125,12895,4,1,770,12,7
02056636,23025,23465,6,2,440,12,7
00f998d2,34025,34815,6,0,790,12,7
0397b0d2,34015,35185,1,3,1170,12,7
053e3016,34225,35545,2,5,1320,12,7
05784c51,34575,35905,3,5,1330,12,7
03de9f95,34485,36265,4,3,1780,12,7
052d6122,34855,37345,0,5,2490,12,7
003d2aa2,34595,37705,1,0,3110,12,7
00069f26,34985,38065,2,0,3080,12,7
02f62634,35415,38425,3,2,3010,12,7
0163eae3,35975,38785,4,1,2810,12,7
02fdd6b1,35835,39145,5,2,3310,12,7
023b8133,35725,39505,6,2,3780,12,7
0474a025,35965,39865,0,4,3900,12,7
00572cf4,36045,40225,1,0,4180,12,7
0362ad54,35865,40585,2,3,4720,12,7
04449232,36095,40945,3,4,4850,12,7
05307620,135005,135385,0,5,380,12,7
0228f1f5,135005,136105,5,2,1100,12,7
02599fa3,135005,136465,3,2,1460,12,7
00fc1294,135005,136825,4,0,1820,12,7
00502bc4,135005,137545,4,0,2540,12,7
06e32494,135005,137905,4,6,2900,12,7
015816d5,135005,138265,5,1,3260,12,7
02a0c8e3,135005,138625,3,2,3620,12,7
0691ae64,135005,138985,4,6,3980,12,7
036adab5,135005,139345,5,3,4340,12,7
03bf9c63,135005,139705,3,3,4700,12,7
0399bf11,135005,140065,1,3,5060,12,7
06976670,337355,337835,0,6,480,12,7
05f72fd1,337155,338195,1,5,1040,12,7
069e94e3,337285,338565,3,6,1280,12,7
02102c34,337185,338925,4,2,1740,12,7
06fb9b60,337505,339315,0,6,1810,12,7
041340a3,337435,339705,3,4,2270,12,7
02e8a381,438035,438545,1,2,510,12,7
02187793,438135,438915,3,2,780,12,7
004bf941,539165,539675,1,0,510,12,7
06535240,1045,1435,0,6,390,13,9
0895e815,12105,12545,5,8,440,13,9
084d6097,12185,12905,6,8,720,13,9
08284656,12505,13265,7,8,760,13,9
0897b0d1,12345,14035,3,8,1690,13,9
083e3014,12605,14425,6,8,1820,13,9
027cd0d8,23035,23425,8,2,390,13,9
003f1768,23085,23935,8,0,850,13,9
02dcd3d2,34045,34525,4,2,480,13,9
03de9f91,34205,34895,6,3,690,13,9
00457ed6,34105,35265,8,0,1160,13,9
01df78c2,34165,35625,0,1,1460,13,9
07784c53,34265,35985,1,7,1720,13,9
07724c65,34255,36345,2,7,2090,13,9
00b582d1,34965,36705,3,0,1740,13,9
082d6122,34465,37065,4,8,2600,13,9
038495c6,34795,37425,5,3,2630,13,9
00a4ec53,34785,37785,6,0,3000,13,9
03e28bd8,34895,38145,7,3,3250,13,9
04ccc9d1,35345,38505,8,4,3160,13,9
01f62636,35035,38865,0,1,3830,13,9
06572cf8,35985,39225,1,6,3240,13,9
0174a023,35745,39585,2,1,3840,13,9
01845aa4,35325,39945,3,1,4620,13,9
0079a0b8,37035,40305,4,0,3270,13,9
02b34d85,36395,40665,5,2,4270,13,9
004b3416,36385,41385,7,0,5000,13,9
000f3782,36495,41745,8,0,5250,13,9
08265b61,36745,42105,0,8,5360,13,9
06bf9c60,36805,42465,1,6,5660,13,9
00502bc6,36895,42825,2,0,5930,13,9
01fdd2a5,36955,43185,3,1,6230,13,9
08187796,135005,135385,6,8,380,13,9
01371952,135005,135745,2,1,740,13,9
047a6fd8,135005,136105,8,4,1100,13,9
08241852,135005,136465,2,8,1460,13,9
00d60b76,135005,136825,6,0,1820,13,9
0425a772,135005,137185,2,4,2180,13,9
08caf2a1,135005,137545,1,8,2540,13,9
018fdf76,135005,137905,6,1,2900,13,9
0890b2a7,135005,138265,7,8,3260,13,9
05b49ca0,135005,138625,0,5,3620,13,9
027e4087,135005,138985,7,2,3980,13,9
04779fa0,135005,139345,0,4,4340,13,9
039a18f4,135005,139705,4,3,4700,13,9
05ccec26,135005,140065,6,5,5060,13,9
04b4b496,135005,140425,6,4,5420,13,9
071ff445,135005,141145,5,7,6140,13,9
02fb9b63,135005,141505,3,2,6500,13,9
05000b90,337155,337535,0,5,380,13,9
014f61a2,337065,337905,2,1,840,13,9
0659f268,438145,438625,8,6,480,13,9
05921c00,438115,438985,0,5,870,13,9
0761ab62,438195,439355,2,7,1160,13,9
079837d1,539095,539645,1,7,550,13,9
03535240,1005,1395,0,3,390,11,4
0197b0d2,12155,12795,3,1,640,11,4
017cd0d1,12315,13155,0,1,840,11,4
013f1763,12325,13885,3,1,1560,11,4
02457ed0,23115,23485,0,2,370,11,4
01cdb8f0,34105,34525,2,1,420,11,4
01a4ec51,34295,34885,3,1,590,11,4
018495c2,34335,35245,0,1,910,11,4
0007ae82,34275,35605,1,0,1330,11,4
03e28bd2,34375,35965,2,3,1590,11,4
023870a1,34545,36325,3,2,1780,11,4
007d6531,34965,37045,1,0,2080,11,4
00fe91d1,35295,37405,2,0,2110,11,4
00bc05b0,135005,135385,0,0,380,11,4
039650a2,135005,135745,2,3,740,11,4
03bf9c62,135005,136105,2,3,1100,11,4
017edc83,135005,136825,3,1,1820,11,4
0150deb2,135005,137185,2,1,2180,11,4
006333a0,135005,137545,0,0,2540,11,4
014569f0,135005,137905,0,1,2900,11,4
00bf6d33,337025,337415,3,0,390,11,4
02a595b3,337135,338855,3,2,1720,11,4
03563581,337325,339575,1,3,2250,11,4
03a0c8e2,337385,339935,2,3,2550,11,4
02bb4a30,438215,438655,0,2,440,11,4
00dbc261,438155,439015,1,0,860,11,4
018565f2,438345,439375,2,1,1030,11,4
0190d440,438435,439745,0,1,1310,11,4
0136cda2,539425,539815,2,1,390,11,4
0291ae61,539175,540205,1,2,1030,11,4
00535243,1045,1515,3,0,470,6,5
0295e814,12065,12485,1,2,420,6,5
024d6091,12075,13205,3,2,1130,6,5
0297b0d1,12165,13575,0,2,1410,6,5
01f998d2,23015,23405,2,1,390,6,5
003e3012,23205,23835,2,0,630,6,5
027cd0d1,34105,34545,4,2,440,6,5
01df78c3,34385,34905,0,1,520,6,5
00dcd3d1,34265,35265,1,0,1000,6,5
043f1760,34195,35625,2,4,1430,6,5
03272771,34745,36345,4,3,1600,6,5
03069f24,34885,36705,0,3,1820,6,5
0007ae82,35045,37065,1,0,2020,6,5
03845aa2,35635,37425,2,3,1790,6,5
027d6530,35935,37785,3,2,1850,6,5
0074a024,36215,38145,4,0,1930,6,5
03a4ec53,35125,38505,0,3,3380,6,5
043b8131,35835,38865,1,4,3030,6,5
03845aa2,35635,39225,2,3,3590,6,5
038bdf22,135005,135385,2,3,380,6,5
0350deb1,135005,135745,1,3,740,6,5
0279a0b1,135005,136105,1,2,1100,6,5
033327e4,135005,136465,4,3,1460,6,5
03fe91d0,135005,136825,0,3,1820,6,5
03502bc3,135005,137545,3,3,2540,6,5
014569f2,337025,337405,2,1,380,6,5
03bc05b0,337105,337795,0,3,690,6,5
04e37892,337155,338165,2,4,1010,6,5
04ec0d73,438125,438535,3,4,410,6,5
02d7f0c4,438285,438895,4,2,610,6,5
0312f960,438235,439255,0,3,1020,6,5
037fc511,438215,439615,1,3,1400,6,5
03535242,1085,1475,2,3,390,10,6
0395e810,12095,12475,1,3,380,10,6
03056630,12195,12835,2,3,640,10,6
0397b0d2,12275,13555,4,3,1280,10,6
03f998d5,12365,13925,0,3,1560,10,6
03284652,12415,14285,1,3,1870,10,6
037cd0d4,12605,15045,0,3,2440,10,6
033e3012,12525,15405,1,3,2880,10,6
023f1765,23085,23545,5,2,460,10,6
02784c55,23505,23995,5,2,490,10,6
04ff7e53,34065,34465,1,4,400,10,6
038495c2,34435,34825,2,3,390,10,6
013870a2,34785,35185,3,1,400,10,6
03272774,34095,35545,4,3,1450,10,6
04cdb8f1,34215,35905,5,4,1690,10,6
032d6120,34165,36265,0,3,2100,10,6
0207ae85,34365,36625,1,2,2260,10,6
00726651,34685,36985,2,0,2300,10,6
01c380d4,35135,37345,3,1,2210,10,6
0214c3c4,35745,38065,5,2,2320,10,6
03502bc0,36245,38425,0,3,2180,10,6
017be715,36445,39145,2,1,2700,10,6
028bdf22,35815,39505,3,2,3690,10,6
0379a0b3,36385,39865,4,3,3480,10,6
04241850,36505,40225,5,4,3720,10,6
02a0c8e1,135005,135745,1,2,740,10,6
048fdf71,135005,136105,1,4,1100,10,6
02c603b2,135005,136465,2,2,1460,10,6
05da9f82,135005,136825,2,5,1820,10,6
0112f965,135005,137185,5,1,2180,10,6
04563585,135005,137545,5,4,2540,10,6
01ae2b51,135005,138265,1,1,3260,10,6
031559f0,135005,138625,0,3,3620,10,6
03ec0d70,135005,138985,0,3,3980,10,6
005816d4,135005,139345,4,0,4340,10,6
05119792,337045,337515,2,5,470,10,6
05fcf0e3,337305,337875,3,5,570,10,6
01ebc9a5,337455,338245,5,1,790,10,6
02daddc0,337395,338605,0,2,1210,10,6
0390b2a1,337145,338965,1,3,1820,10,6
04f72fd2,337525,339325,2,4,1800,10,6
04fb9b63,539455,540235,3,4,780,10,6
05187794,539485,540595,4,5,1110,10,6
024d6091,12105,12965,3,2,860,13,10
0297b0d5,12225,13335,5,2,1110,13,10
02056633,12125,13695,6,2,1570,13,10
02dcd3d0,12585,14055,7,2,1470,13,10
027cd0d8,12455,14415,8,2,1960,13,10
02f998d2,12245,14775,9,2,2530,13,10
023f1760,12535,15135,0,2,2600,13,10
023e3013,12435,15865,3,2,3430,13,10
04457ed6,23095,23485,6,4,390,13,10
09df78c6,34065,34465,5,9,400,13,10
07724c69,34225,35215,9,7,990,13,10
03cdb8f0,34525,35935,1,3,1410,13,10
01de9f95,34145,36295,2,1,2150,13,10
0063eae5,35785,36655,3,0,870,13,10
06b582d7,34865,37015,4,6,2150,13,10
05845aa0,35215,37735,6,5,2520,13,10
038495c5,34755,38095,7,3,3340,13,10
02a4ec55,34705,38825,0,2,4120,13,10
07fe91d7,35855,39185,1,7,3330,13,10
063b8133,35315,39545,2,6,4230,13,10
084b3413,36265,39905,3,8,3640,13,10
03b34d84,36365,40265,4,3,3900,13,10
0014c3c0,36125,40625,5,0,4500,13,10
007d6533,35475,40985,6,0,5510,13,10
00fdd6b8,35535,41345,7,0,5810,13,10
09a12895,36485,41705,8,9,5220,13,10
0550deb6,36555,42075,0,5,5520,13,10
05e618a6,36205,42435,1,5,6230,13,10
02c4bd90,135005,135385,0,2,380,13,10
09ec0d76,135005,135745,6,9,740,13,10
07bf6d33,135005,136105,3,7,1100,13,10
04fb6650,135005,136825,0,4,1820,13,10
02eed569,135005,137185,9,2,2180,13,10
03cde4d3,135005,137545,3,3,2540,13,10
09cd9284,135005,137905,4,9,2900,13,10
015c4700,135005,138265,0,1,3260,13,10
06bf9c69,135005,138625,9,6,3620,13,10
08e32496,135005,138985,6,8,3980,13,10
019e7390,135005,139345,0,1,4340,13,10
07599fa3,135005,139705,3,7,4700,13,10
072e2ed5,135005,140065,5,7,5060,13,10
03f72fd5,135005,140425,5,3,5420,13,10
077ca593,135005,140785,3,7,5780,13,10
00ebab45,135005,141145,5,0,6140,13,10
057c63d5,135005,141505,5,5,6500,13,10
09a4b150,135005,142225,0,9,7220,13,10
083ff787,337035,337495,7,8,460,13,10
01a9b7e3,337115,337945,3,1,830,13,10
02d80db4,337155,338305,4,2,1150,13,10
02409173,438255,438665,3,2,410,13,10
05578a14,438285,439025,4,5,740,13,10
04396505,438395,439385,5,4,990,13,10
01791866,438315,439745,6,1,1430,13,10
02c59f53,438415,440545,3,2,2130,13,10
00a8a293,539065,539475,3,0,410,13,10
03535246,1075,1515,6,3,440,1,13
0c95e818,12085,12465,3,12,380,1,13
014d6094,23095,23485,4,1,390,1,13
00056635,34065,34565,8,0,500,1,13
0897b0d4,34105,34975,12,8,870,1,13
017cd0db,34405,35335,0,1,930,1,13
02df78c3,34645,35695,1,2,1050,1,13
04f998d1,34165,36055,2,4,1890,1,13
06724c68,34795,36775,4,6,1980,1,13
0375212a,34315,37135,5,3,2820,1,13
03b582dc,35555,37495,6,3,1940,1,13
01284656,34265,37855,7,1,3590,1,13
00056635,34065,38215,8,0,4150,1,13
0b696cea,35245,38575,9,11,3330,1,13
07457ed4,34575,38935,10,7,4360,1,13
0c272772,34965,39295,11,12,4330,1,13
0897b0d4,34105,39655,12,8,5550,1,13
017cd0db,34405,40015,0,1,5610,1,13
02df78c3,34645,40375,1,2,5730,1,13
04f998d1,34165,40735,2,4,6570,1,13
06724c68,34795,41455,4,6,6660,1,13
0375212a,34315,41815,5,3,7500,1,13
03b582dc,35555,42175,6,3,6620,1,13
01284656,34265,42535,7,1,8270,1,13
00056635,34065,42895,8,0,8830,1,13
0b696cea,35245,43255,9,11,8010,1,13
07457ed4,34575,43615,10,7,9040,1,13
0c272772,34965,43975,11,12,9010,1,13
0897b0d4,34105,44335,12,8,10230,1,13
017cd0db,34405,44695,0,1,10290,1,13
02df78c3,34645,45055,1,2,10410,1,13
04f998d1,34165,45415,2,4,11250,1,13
06724c68,34795,45785,4,6,10990,1,13
0375212a,34315,46145,5,3,11830,1,13
04d945c2,135005,135385,2,4,380,1,13
016333a6,135005,135745,6,1,740,1,13
063327ea,135005,136105,10,6,1100,1,13
08a4b15b,135005,136465,11,8,1460,1,13
0099bf13,135005,136825,3,0,1820,1,13
06c4bd91,135005,137185,1,6,2180,1,13
01307627,135005,137545,7,1,2540,1,13
025fb4c5,135005,137905,5,2,2900,1,13
0c1559fc,135005,138265,12,12,3260,1,13
049a18f6,135005,138625,6,4,3620,1,13
04da9f80,135005,138985,0,4,3980,1,13
0bd60b71,135005,139345,1,11,4340,1,13
024569fc,135005,139705,12,2,4700,1,13
06e3789c,337075,337595,12,6,520,1,13
01e32495,539035,539485,5,1,450,1,13
01535240,1085,1475,0,1,390,15,2
00056630,12175,12805,1,0,630,15,2
00b582d1,135005,135385,1,0,380,15,2
018495c1,135005,136465,1,1,1460,15,2
010f3780,337085,337475,0,1,390,15,2
00bf9c61,337205,337835,1,0,630,15,2
01c4bd90,438425,439275,0,1,850,15,2
0099bf11,438405,439635,1,0,1230,15,2
004569f1,539225,539975,1,0,750,15,2
02535241,1045,1495,1,2,450,4,4
0295e812,12105,12485,0,2,380,4,4
024d6090,12115,12845,1,2,730,4,4
02056632,12135,13215,3,2,1080,4,4
0297b0d1,12175,13585,1,2,1410,4,4
03f998d0,23015,23405,0,3,390,4,4
013e3010,23245,23815,0,1,570,4,4
01069f20,135005,135385,0,1,380,4,4
013f1763,135005,135745,3,1,740,4,4
00de9f90,135005,136105,0,0,1100,4,4
00ff7e52,135005,136465,2,0,1460,4,4
02e28bd3,337015,337415,3,2,400,4,4
02b582d0,337035,337775,0,2,740,4,4
01726653,337095,338165,3,1,1070,4,4
013870a2,438105,438485,2,1,380,4,4
03f62630,438085,438855,0,3,770,4,4
01845aa3,539115,539525,3,1,410,4,4
0a535243,1095,1535,3,10,440,16,14
064d6090,12035,12445,12,6,410,16,14
067cd0d6,12385,12835,1,6,450,16,14
06056633,12055,13205,3,6,1150,16,14
0695e81c,12015,13565,4,6,1550,16,14
0697b0dd,12065,13955,7,6,1890,16,14
06752127,12235,14345,10,6,2110,16,14
0628465a,12215,14705,11,6,2490,16,14
06f998db,12145,15065,12,6,2920,16,14
063e3019,12305,15515,4,6,3210,16,14
033f1765,23015,23585,5,3,570,16,14
02dcd3d3,34065,34585,5,2,520,16,14
03de9f95,34185,34945,6,3,760,16,14
0bff7e5a,34335,35305,7,11,970,16,14
0c784c5c,34265,35665,8,12,1400,16,14
022d6124,34385,36025,9,2,1640,16,14
01457ed9,34085,36385,10,1,2300,16,14
06df78c4,34145,36745,11,6,2600,16,14
068495cd,34865,37105,12,6,2240,16,14
01a4ec56,34795,37465,13,1,2670,16,14
04724c67,34235,37825,0,4,3590,16,14
05b582db,34975,38185,1,5,3210,16,14
0b726656,35055,38545,2,11,3490,16,14
0c696ce0,34615,38905,3,12,4290,16,14
0027277c,34365,39265,4,0,4900,16,14
023b8133,35535,39625,5,2,4090,16,14
08e28bdc,34875,39985,6,8,5110,16,14
04fdd6b8,35785,40345,7,4,4560,16,14
0cc4bd9b,37525,40705,8,12,3180,16,14
0763eae9,35985,41065,9,7,5080,16,14
0874a026,35965,41425,10,8,5460,16,14
00fe91d9,36075,41785,11,0,5710,16,14
038bdf2a,36275,42145,12,3,5870,16,14
0c6333a9,37345,42505,13,12,5160,16,14
09b34d89,36455,42865,0,9,6410,16,14
0c572cf6,36085,43225,1,12,7140,16,14
0930762a,37535,43945,3,9,6410,16,14
01513ae4,36795,44305,4,1,7510,16,14
092554f8,37195,44665,5,9,7470,16,14
04fdd2aa,36895,45025,6,4,8130,16,14
041559f3,37715,45385,7,4,7670,16,14
0d99bf10,37505,45755,9,13,8250,16,14
0d79a0b2,36975,46115,10,13,9140,16,14
07a4b15d,37475,46475,11,7,9000,16,14
095fb4cb,37625,46845,13,9,9220,16,14
0aa1d2ad,135005,135385,13,10,380,16,14
05b3b7f6,135005,135745,6,5,740,16,14
000e5366,135005,136105,6,0,1100,16,14
00e1bd1d,135005,136465,13,0,1460,16,14
085dca18,135005,136825,8,8,1820,16,14
09da9f87,135005,137185,7,9,2180,16,14
07cdb125,135005,137545,5,7,2540,16,14
0b599fad,135005,137905,13,11,2900,16,14
06ae2b56,135005,138265,6,6,3260,16,14
01fb9b6b,135005,138625,11,1,3620,16,14
0c9837d1,135005,139705,1,12,4700,16,14
04a8a293,135005,140065,3,4,5060,16,14
0afd392a,135005,140425,10,10,5420,16,14
04290ef4,135005,140785,4,4,5780,16,14
039fdec6,135005,141145,6,3,6140,16,14
09112397,135005,141505,7,9,6500,16,14
092d5552,135005,141865,2,9,6860,16,14
0325a775,135005,142225,5,3,7220,16,14
05a0c8e6,135005,142585,6,5,7580,16,14
0536cda4,135005,142945,4,5,7940,16,14
0b976678,135005,143305,8,11,8300,16,14
0172db68,135005,143665,8,1,8660,16,14
0a7901cb,135005,144025,11,10,9020,16,14
0259f264,135005,144385,4,2,9380,16,14
00c59f56,135005,144745,6,0,9740,16,14
036c09f5,135005,145105,5,3,10100,16,14
065bbdba,337115,337555,10,6,440,16,14
003b1513,337205,338695,3,0,1490,16,14
0b5427c6,438195,438605,6,11,410,16,14
03620457,438135,438965,7,3,830,16,14
0510583d,438175,439415,13,5,1240,16,14
07614720,438275,439775,0,7,1500,16,14
05f3cfe1,438305,440135,1,5,1830,16,14
065f2685,539095,539545,5,6,450,16,14
014d6090,23035,23415,0,1,380,1,2
00056630,34055,34435,1,0,380,1,2
00056630,34055,35155,1,0,1100,1,2
00056630,34055,35875,1,0,1820,1,2
00056630,34055,36595,1,0,2540,1,2
00056630,34055,37315,1,0,3260,1,2
00056630,34055,38035,1,0,3980,1,2
00fdd2a0,135005,135385,0,0,380,1,2
007be711,337015,337415,1,0,400,1,2
024d6091,12065,12795,1,2,730,11,3
02056630,23015,23395,0,2,380,11,3
017cd0d0,23325,23785,0,1,460,11,3
01df78c0,23615,24175,0,1,560,11,3
02de9f92,34055,34445,0,2,390,11,3
022d6120,34395,34805,1,2,410,11,3
00724c60,34115,35165,2,0,1050,11,3
00b582d2,34885,36245,2,0,1360,11,3
01ccc9d2,35335,36605,0,1,1270,11,3
0074a020,35665,37325,2,0,1660,11,3
01ccc9d2,35335,37685,0,1,2350,11,3
01449231,135005,135385,1,1,380,11,3
02265b62,135005,135745,2,2,740,11,3
01a12891,135005,136465,1,1,1460,11,3
01d60b72,135005,137185,2,1,2180,11,3
017fc510,337065,337475,0,1,410,11,3
01d7f0c0,337195,338205,0,1,1010,11,3
00cdb122,438205,438595,2,0,390,11,3
025007e1,438235,439315,1,2,1080,11,3
015816d2,438265,439675,2,1,1410,11,3
029e7390,438295,440035,0,2,1740,11,3
01caf2a0,539515,539935,0,1,420,11,3
09535241,1005,1495,1,9,490,15,14
0d95e81c,12095,12525,2,13,430,15,14
0d056637,12205,12935,6,13,730,15,14
0d97b0db,12305,13345,10,13,1040,15,14
0d4d6091,12115,13715,12,13,1600,15,14
0df998d8,12325,14105,1,13,1780,15,14
073f1760,23255,24095,0,7,840,15,14
0ddcd3d2,34035,34445,12,13,410,15,14
08724c68,34145,34805,13,8,660,15,14
0adf78c1,34055,35195,2,10,1140,15,14
09ff7e58,34275,35555,3,9,1280,15,14
01de9f94,34065,35915,4,1,1850,15,14
0b784c54,34165,36275,5,11,2110,15,14
02457eda,34045,36635,6,2,2590,15,14
02b22809,35225,37355,8,2,2130,15,14
08ccc9da,35335,37715,9,8,2380,15,14
07696ce2,34605,38075,10,7,3470,15,14
01272775,34345,38795,12,1,4450,15,14
023b8130,35435,39515,0,2,4080,15,14
0b03e96b,35345,39875,1,11,4530,15,14
01b582db,34955,40235,2,1,5280,15,14
029650a2,35955,40595,3,2,4640,15,14
0b74a02c,35745,40955,4,11,5210,15,14
0ce618a6,36205,41315,5,12,5110,15,14
0514c3c1,36035,41675,6,5,5640,15,14
000f378c,36385,42035,7,0,5650,15,14
038bdf2b,36125,42395,8,3,6270,15,14
0463eaec,35785,42755,9,4,6970,15,14
0cf62632,35145,43115,10,12,7970,15,14
014b3413,36255,43475,11,1,7220,15,14
07845aa8,35305,43835,12,7,8530,15,14
0262ad59,35645,44195,13,2,8550,15,14
07fe91d5,35805,44555,0,7,8750,15,14
0c30aca9,36005,44925,2,12,8920,15,14
0cb34d8d,36355,45285,3,12,8930,15,14
0a3ff78b,135005,135385,11,10,380,15,14
06574c56,135005,135745,6,6,740,15,14
005f48d0,135005,136105,0,0,1100,15,14
0b83dc9d,135005,136825,13,11,1820,15,14
0b50debb,135005,137185,11,11,2180,15,14
0712f960,135005,137905,0,7,2900,15,14
00b4b494,135005,138265,4,0,3260,15,14
0b8fdf76,135005,138625,6,11,3620,15,14
02fcf0e7,135005,138985,7,2,3980,15,14
07f2c040,135005,139345,0,7,4340,15,14
0118d88b,135005,139705,11,1,4700,15,14
0b504731,135005,140065,1,11,5060,15,14
03a8a29b,135005,140425,11,3,5420,15,14
02fb52a8,135005,140785,8,2,5780,15,14
0dfd392a,135005,141145,10,13,6140,15,14
0d51e0b0,135005,141505,0,13,6500,15,14
05cf61e8,135005,141865,8,5,6860,15,14
08a4b15b,135005,142225,11,8,7220,15,14
06ec0d77,135005,142585,7,6,7580,15,14
0348878d,135005,142945,13,3,7940,15,14
008565f8,135005,143305,8,0,8300,15,14
0790b2a6,135005,143665,6,7,8660,15,14
084bf944,135005,144025,4,8,9020,15,14
0b807690,135005,144385,0,11,9380,15,14
0dea7669,135005,144745,9,13,9740,15,14
0df0fdc1,135005,145105,1,13,10100,15,14
06fe9535,337015,337455,5,6,440,15,14
026fae26,337255,337815,6,2,560,15,14
0cc225bb,337155,338245,11,12,1090,15,14
0b962561,337055,338655,1,11,1600,15,14
053e2046,337315,339085,6,5,1770,15,14
09c0373b,539055,539635,11,9,580,15,14
01535248,1045,1595,8,1,550,16,9
074d6093,12155,12535,4,7,380,16,9
07f998d3,12365,12895,5,7,530,16,9
0795e817,12105,13255,6,7,1150,16,9
07056632,12245,13625,8,7,1380,16,9
07752127,12445,13985,0,7,1540,16,9
073e3012,12525,14375,3,7,1850,16,9
077cd0d1,12535,14735,4,7,2200,16,9
0797b0d8,12295,15105,6,7,2810,16,9
053f1764,23035,23525,4,5,490,16,9
06ff7e54,23465,24035,4,6,570,16,9
03696ce4,23755,24545,4,3,790,16,9
0707ae84,34105,34505,3,7,400,16,9
06a4ec50,34205,34865,4,6,660,16,9
058495c6,34295,35585,6,5,1290,16,9
03b22802,34605,35945,7,3,1340,16,9
0203e962,34885,36305,8,2,1420,16,9
02b34d83,35775,37025,1,2,1250,16,9
06845aa6,34705,38105,4,6,3400,16,9
0774a023,35235,38465,5,7,3230,16,9
0263eae4,35295,38825,6,2,3530,16,9
03a12897,35855,39185,7,3,3330,16,9
017be712,36295,39545,8,1,3250,16,9
012554f2,36405,39905,0,1,3500,16,9
0479a0b4,36265,40265,1,4,4000,16,9
01fdd2a1,36245,40625,2,1,4380,16,9
0750deb1,35915,41345,4,7,5430,16,9
04502bc6,36235,41705,5,4,5470,16,9
07513ae1,36135,42065,6,7,5930,16,9
08241851,36345,42425,7,8,6080,16,9
010042d4,135005,135385,4,1,380,16,9
05779fa6,135005,135745,6,5,740,16,9
07d2b792,135005,136105,2,7,1100,16,9
086333a1,135005,136465,1,8,1460,16,9
0533ed01,135005,136825,1,5,1820,16,9
06488781,135005,137185,1,6,2180,16,9
0690d448,135005,137545,8,6,2540,16,9
08fcf0e8,135005,137905,8,8,2900,16,9
07199ba3,135005,138625,3,7,3620,16,9
01d80db3,135005,138985,3,1,3980,16,9
04c42732,135005,139345,2,4,4340,16,9
00bf6d35,135005,140065,5,0,5060,16,9
04292b33,135005,140425,3,4,5420,16,9
0290b2a0,135005,140785,0,2,5780,16,9
0765d930,135005,141145,0,7,6140,16,9
0218d880,135005,141505,0,2,6500,16,9
01efda98,337115,337515,8,1,400,16,9
03bb90e2,337295,338245,2,3,950,16,9
04a8ca10,337205,338715,0,4,1510,16,9
035f48d7,438255,438725,7,3,470,16,9
07de6388,438415,439085,8,7,670,16,9
04a1d2a0,438235,439445,0,4,1210,16,9
045ff9e3,438325,439835,3,4,1510,16,9
01fa8797,438445,440245,7,1,1800,16,9
034e3c81,539055,539465,1,3,410,16,9
01fd3923,539555,539965,3,1,410,16,9
0359dba4,539385,540325,4,3,940,16,9
0b535240,1075,1655,0,11,580,4,13
0a95e81a,12015,12505,5,10,490,4,13
0a4d6091,12105,12975,12,10,870,4,13
0a056637,12155,13565,12,10,1410,4,13
0897b0d3,23055,23465,3,8,410,4,13
04284653,23165,24055,3,4,890,4,13
0a3e301c,34075,34505,5,10,430,4,13
09de9f9a,34475,34875,7,9,400,4,13
063f1762,34255,35605,10,6,1350,4,13
05dcd3d7,34325,35975,12,5,1650,4,13
0a8495c9,34905,36335,0,10,1430,4,13
0a3870a4,35085,37055,2,10,1970,4,13
0bdf78c9,34455,37415,3,11,2960,4,13
01696ceb,34805,37775,4,1,2970,4,13
0903e961,35315,38135,5,9,2820,4,13
0ccdb8f8,34755,38495,6,12,3740,4,13
033d2aa1,34535,38855,7,3,4320,4,13
01784c58,34505,39215,8,1,4710,4,13
0c449234,35855,39575,9,12,3720,4,13
06a4ec5c,34885,39935,10,6,5050,4,13
0a9650a0,35925,40295,11,10,4370,4,13
03fe91da,35745,40655,12,3,4910,4,13
0c63eae2,35715,41015,0,12,5300,4,13
0a50deb4,36305,41375,1,10,5070,4,13
09b2280b,35125,41735,2,9,6610,4,13
08241856,36795,42095,3,8,5300,4,13
030f3785,36265,42455,4,3,6190,4,13
027d6532,35515,42815,5,2,7300,4,13
07572cf5,35825,43175,6,7,7350,4,13
04c380d1,35495,43535,7,4,8040,4,13
01a12894,36285,43905,9,1,7620,4,13
0a4b341a,36175,44275,11,10,8100,4,13
027be714,36785,44635,12,2,7850,4,13
0c63eae2,35715,44995,0,12,9280,4,13
0a6333a7,135005,135745,7,10,740,4,13
0cc4bd91,135005,136105,1,12,1100,4,13
009a18fa,135005,136465,10,0,1460,4,13
07d945c8,135005,136825,8,7,1820,4,13
0333ed00,135005,137185,0,3,2180,4,13
06d7f0cb,135005,137545,11,6,2540,4,13
012ed3d0,135005,137905,0,1,2900,4,13
0b9e739b,135005,138265,11,11,3260,4,13
04488781,135005,138625,1,4,3620,4,13
0ccaf2aa,135005,138985,10,12,3980,4,13
0bff29c2,135005,139345,2,11,4340,4,13
07bb4a36,135005,139705,6,7,4700,4,13
0036cdac,337105,337595,12,0,490,4,13
042e2ed3,337075,338005,3,4,930,4,13
02119799,539275,539805,9,2,530,4,13
01535242,1035,1425,2,1,390,12,3
02056630,12125,12845,0,2,720,12,3
024d6092,12115,13205,1,2,1090,12,3
02457ed2,12825,13925,0,2,1100,12,3
027cd0d1,12565,14285,1,2,1720,12,3
01df78c0,23025,23445,0,1,420,12,3
01272770,23385,23835,0,1,450,12,3
00696ce1,34055,34465,1,0,410,12,3
02b22801,34545,35185,0,2,640,12,3
00f62632,34465,35545,1,0,1080,12,3
01c380d0,34835,35905,2,1,1070,12,3
0263eae0,35165,36265,0,2,1100,12,3
00e618a0,35435,36625,1,0,1190,12,3
008bdf21,35405,36985,2,0,1580,12,3
00e618a0,35435,37705,1,0,2270,12,3
008bdf21,35405,38065,2,0,2660,12,3
0299bf12,36625,38425,0,2,1800,12,3
00e618a0,35435,38785,1,0,3350,12,3
007edc82,135005,135745,2,0,740,12,3
01b4b490,135005,136105,0,1,1100,12,3
01d7f0c0,135005,136465,0,1,1460,12,3
00488782,135005,136825,2,0,1820,12,3
01bb4a31,135005,137185,1,1,2180,12,3
01ae2b52,337015,337405,2,1,390,12,3
001ff441,438205,438935,1,0,730,12,3
006adab2,539135,539535,2,0,400,12,3
01535243,1075,1465,3,1,390,5,4
0295e811,12065,12485,0,2,420,5,4
02056630,12135,12845,1,2,710,5,4
0397b0d1,23085,23505,1,3,420,5,4
00f998d1,23125,23915,1,0,790,5,4
01284653,34105,34885,3,1,780,5,4
02457ed2,34475,35245,0,2,770,5,4
007cd0d1,34285,35605,1,0,1320,5,4
00272772,34895,36325,3,0,1430,5,4
033870a2,35355,37045,1,3,1690,5,4
00f62632,35315,37765,3,0,2450,5,4
01c380d1,135005,135745,1,1,740,5,4
0363eae2,135005,136105,2,3,1100,5,4
0030aca2,135005,136465,2,0,1460,5,4
0050deb1,135005,136825,1,0,1820,5,4
0162ad51,135005,137185,1,1,2180,5,4
00e618a2,135005,137905,2,0,2900,5,4
01fdd2a3,337035,337415,3,1,380,5,4
03241850,337175,337775,0,3,600,5,4
037be712,337135,338145,2,3,1010,5,4
012554f3,337255,338505,3,1,1250,5,4
0299bf13,539225,539635,3,2,410,5,4
0695e818,12095,12525,4,6,430,7,9
06f998d4,12325,13255,7,6,930,7,9
06284650,12425,13685,3,6,1260,7,9
064d6094,12145,14045,4,6,1900,7,9
03752124,23055,23525,4,3,470,7,9
08dcd3d7,34035,34465,1,8,430,7,9
05457ed3,34055,34825,2,5,770,7,9
023d2aa0,34365,35185,3,2,820,7,9
01784c55,34315,35545,4,1,1230,7,9
00724c65,34215,35905,5,0,1690,7,9
00ff7e55,34395,36265,6,0,1870,7,9
01df78c6,34115,36635,8,1,2520,7,9
06272776,34435,37365,2,6,2930,7,9
002d6127,34485,37755,5,0,3270,7,9
01241851,135005,135385,1,1,380,7,9
03069f20,135005,136465,0,3,1460,7,9
0303e965,135005,137185,5,3,2180,7,9
0663eae1,135005,137545,1,6,2540,7,9
008bdf27,135005,137905,7,0,2900,7,9
08265b63,135005,138265,3,8,3260,7,9
06da9f83,135005,138985,3,6,3980,7,9
0733ed01,135005,139345,1,7,4340,7,9
05e28bd8,135005,139705,8,5,4700,7,9
06845aa8,135005,140065,8,6,5060,7,9
0662ad54,135005,140425,4,6,5420,7,9
0230aca8,135005,140785,8,2,5780,7,9
02a12890,135005,141145,0,2,6140,7,9
0279a0b1,135005,141505,1,2,6500,7,9
005007e5,337125,338305,5,0,1180,7,9
025816d5,337185,338815,5,2,1630,7,9
019e7395,438025,438485,5,1,460,7,9
0028f1f7,438045,438855,7,0,810,7,9
04a595b6,539165,539635,6,4,470,7,9
0053524a,1055,1595,10,0,540,7,13
094d609a,12105,12545,7,9,440,7,13
0995e818,12095,12975,12,9,880,7,13
09056638,12205,13405,4,9,1200,7,13
0297b0d0,23065,23665,0,2,600,7,13
023f1760,23365,24255,0,2,890,7,13
02457edc,34085,34565,8,2,480,7,13
04df78c7,34135,34925,9,4,790,7,13
0adcd3d2,34075,35315,12,10,1240,7,13
03724c66,34245,35705,2,3,1460,7,13
07ff7e54,34355,36095,5,7,1740,7,13
013d2aa5,34325,36815,7,1,2490,7,13
06de9f95,34215,37175,8,6,2960,7,13
0a696ce6,34695,37535,9,10,2840,7,13
02845aa2,35425,37895,10,2,2470,7,13
02449239,36185,38255,11,2,2070,7,13
09b22809,35285,38615,12,9,3330,7,13
0bc380dc,35705,38975,0,11,3270,7,13
0562ad5c,35885,39335,1,5,3450,7,13
0342120b,35355,39695,2,3,4340,7,13
056333a7,37375,40055,3,5,2680,7,13
09fe91d3,36015,40415,4,9,4400,7,13
0907ae83,34725,40775,5,9,6050,7,13
0714c3c9,36365,41135,6,7,4770,7,13
08b34d8b,36535,41495,7,8,4960,7,13
01241854,37175,41855,8,1,4680,7,13
0c7be713,37125,42215,9,12,5090,7,13
04a12892,36615,42575,10,4,5960,7,13
02c603b4,37305,42935,11,2,5630,7,13
058bdf24,36385,43295,12,5,6910,7,13
0c2554fc,37255,43655,0,12,6400,7,13
0979a0ba,37045,44015,1,9,6970,7,13
0c9650a7,36245,44375,2,12,8130,7,13
01e618ab,36425,44745,4,1,8320,7,13
08b49ca1,135005,135385,1,8,380,7,13
05a4b154,135005,135745,4,5,740,7,13
09da9f8a,135005,136105,10,9,1100,7,13
0a33ed0a,135005,136465,10,10,1460,7,13
0125a775,135005,136825,5,1,1820,7,13
05bf6d39,135005,137185,9,5,2180,7,13
03bb4a3b,135005,137905,11,3,2900,7,13
0991ae6b,135005,138265,11,9,3260,7,13
09e94df9,135005,138625,9,9,3620,7,13
0cdaddc7,135005,138985,7,12,3980,7,13
001340a3,135005,139345,3,0,4340,7,13
0af2c044,135005,139705,4,10,4700,7,13
03261f72,135005,140065,2,3,5060,7,13
02e37891,135005,140785,1,2,5780,7,13
09ccec20,135005,141145,0,9,6140,7,13
019e7390,135005,141505,0,1,6500,7,13
072ae3fb,135005,141865,11,7,6860,7,13
06dbc26c,135005,142225,12,6,7220,7,13
058fdf7a,135005,142585,10,5,7580,7,13
03fb6651,135005,142945,1,3,7940,7,13
006adab9,135005,143305,9,0,8300,7,13
079e94e3,135005,143665,3,7,8660,7,13
034bf947,135005,144025,7,3,9020,7,13
094266da,135005,144385,10,9,9380,7,13
06ebab41,337015,337635,1,6,620,7,13
03cd9282,337165,337995,2,3,830,7,13
0118d884,337105,338365,4,1,1260,7,13
0b530c77,337345,338755,7,11,1410,7,13
050042d4,337265,339285,4,5,2020,7,13
007a6fd6,438205,438655,6,0,450,7,13
0b1451c8,438185,439025,8,11,840,7,13
007901cc,438355,439435,12,0,1080,7,13
0ae07290,438265,439795,0,10,1530,7,13
07199ba4,539485,539915,4,7,430,7,13
01504735,539435,540275,5,1,840,7,13
0c535242,1005,1435,2,12,430,11,13
0095e81b,12065,12505,5,0,440,11,13
004d6097,12165,12875,7,0,710,11,13
0005663a,12265,13235,8,0,970,11,13
00f998d9,12395,13595,9,0,1200,11,13
00752122,12465,13985,12,0,1520,11,13
0097b0d1,12355,14435,5,0,2080,11,13
00284655,12445,14805,7,0,2360,11,13
013e3016,23015,23525,6,1,510,11,13
08724c66,23425,24115,6,8,690,11,13
0a3d2aa3,34145,34545,7,10,400,11,13
0a069f2a,34505,34905,8,10,400,11,13
08ff7e5c,34245,35265,9,8,1020,11,13
08f62636,35015,35635,11,8,620,11,13
06784c53,34045,35995,12,6,1950,11,13
0362ad59,35545,36355,0,3,810,11,13
008495c9,34815,36715,1,0,1900,11,13
063870a4,35035,37435,3,6,2400,11,13
08272775,34255,37795,4,8,3540,11,13
06e28bdb,34825,38155,5,6,3330,11,13
0103e966,35195,38515,6,1,3320,11,13
0b726652,34915,38875,7,11,3960,11,13
0cc380d6,35335,39245,9,12,3910,11,13
04fe91d8,35685,39605,10,4,3920,11,13
057d6530,35395,39965,11,5,4570,11,13
0574a020,35635,40695,1,5,5060,11,13
03b34d80,36275,41055,2,3,4780,11,13
09fdd6b7,35445,41415,3,9,5970,11,13
0a0f3784,36305,42135,5,10,5830,11,13
013b8136,35255,42495,6,1,7240,11,13
0263eaeb,35655,42855,7,2,7200,11,13
03e618a0,36145,43245,10,3,7100,11,13
07a1289a,36325,43605,11,7,7280,11,13
058bdf28,36065,43965,12,5,7900,11,13
00f0fdc0,135005,135385,0,0,380,11,13
06265b65,135005,135745,5,6,740,11,13
033327e8,135005,136105,8,3,1100,11,13
0bd945c1,135005,136465,1,11,1460,11,13
0025a77a,135005,136825,10,0,1820,11,13
05b4b497,135005,137185,7,5,2180,11,13
019a82f9,135005,137545,9,1,2540,11,13
07fb665c,135005,137905,12,7,2900,11,13
09f72fd4,135005,138265,4,9,3260,11,13
0565d931,135005,138625,1,5,3620,11,13
0a71a46b,135005,138985,11,10,3980,11,13
031451c2,135005,139345,2,3,4340,11,13
05ab35e9,135005,139705,9,5,4700,11,13
03409175,135005,140065,5,3,5060,11,13
0bc603b5,135005,140425,5,11,5420,11,13
03d60b78,135005,140785,8,3,5780,11,13
01ccec27,135005,141145,7,1,6140,11,13
07617731,135005,141865,1,7,6860,11,13
0b2e2ed6,135005,142225,6,11,7220,11,13
09daddc2,135005,142585,2,9,7580,11,13
08bc4b88,135005,142945,8,8,7940,11,13
0672db61,135005,143305,1,6,8300,11,13
01c9c2ea,135005,143665,10,1,8660,11,13
0c504735,135005,144025,5,12,9020,11,13
0b2e6ecc,337085,337595,12,11,510,11,13
010168a3,337145,338005,3,1,860,11,13
018d14e7,337175,338415,7,1,1240,11,13
06466e60,438285,438895,0,6,610,11,13
086c09f4,438375,439305,4,8,930,11,13
00fb52a5,438475,439665,5,0,1190,11,13
055f48d6,438585,440025,6,5,1440,11,13
085ff9e7,438675,440385,7,8,1710,11,13
09a1d2a4,438565,440915,4,9,2350,11,13
076abc43,539485,539905,3,7,420,11,13
08bddb66,539405,540295,6,8,890,11,13
05295b97,539495,540655,7,5,1160,11,13
0b7aec70,539395,541105,0,11,1710,11,13
02535241,1035,1495,1,2,460,16,14
0995e817,12045,12505,1,9,460,16,14
094d6097,12125,13015,10,9,890,16,14
0905663d,12145,13375,11,9,1230,16,14
0928465c,12375,13735,12,9,1360,16,14
0997b0d0,12235,14125,1,9,1890,16,14
09f998d3,12325,14655,11,9,2330,16,14
05752127,23015,23625,7,5,610,16,14
013d2aa7,23625,24235,7,1,610,16,14
0c069f27,23845,24845,7,12,1000,16,14
03e28bd7,34185,34805,13,3,620,16,14
0407ae82,34085,35165,0,4,1080,16,14
05a4ec5c,34145,35525,1,5,1380,16,14
088495c6,34175,35895,3,8,1720,16,14
0c7c63d2,135005,135385,2,12,380,16,14
00f0fdcb,135005,135745,11,0,740,16,14
0a175c12,135005,136105,2,10,1100,16,14
085f48db,135005,136465,11,8,1460,16,14
03390862,135005,136825,2,3,1820,16,14
08726655,135005,137185,5,8,2180,16,14
05572cf7,135005,137545,7,5,2540,16,14
03fdd2a2,135005,137905,2,3,2900,16,14
0cd60b75,135005,138265,5,12,3260,16,14
065007e4,135005,138625,4,6,3620,16,14
06dbc266,135005,138985,6,6,3980,16,14
0be94df6,135005,139345,6,11,4340,16,14
0de8a384,135005,139705,4,13,4700,16,14
0d49b047,135005,140065,7,13,5060,16,14
0561ab6a,135005,140425,10,5,5420,16,14
09488358,135005,140785,8,9,5780,16,14
07fb52a3,135005,141145,3,7,6140,16,14
0569ab47,135005,141505,7,5,6500,16,14
0183dc98,135005,141865,8,1,6860,16,14
0163eaed,135005,142225,13,1,7220,16,14
05513aed,135005,142585,13,5,7580,16,14
009a18f5,135005,142945,5,0,7940,16,14
022ed3da,135005,143305,10,2,8300,16,14
03ff29c6,135005,143665,6,3,8660,16,14
01fb6658,135005,144025,8,1,9020,16,14
071340ad,135005,144385,13,7,9380,16,14
0b371959,135005,144745,9,11,9740,16,14
01567860,135005,145105,0,1,10100,16,14
08cf61e9,337135,337535,9,8,400,16,14
029b0c2d,337095,337945,13,2,850,16,14
0d9fdec0,337275,338305,0,13,1030,16,14
0c61c862,337475,338675,2,12,1200,16,14
063050d3,337215,339035,3,6,1820,16,14
08024414,337525,339395,4,8,1870,16,14
0839d185,337375,339755,5,8,2380,16,14
044f9d8b,337625,340545,11,4,2920,16,14
0af643b6,337555,341055,6,10,3500,16,14
000b4d88,438485,438995,8,0,510,16,14
0805d819,438795,439355,9,8,560,16,14
08344b8a,438625,439715,10,8,1090,16,14
0311239b,438705,440075,11,3,1370,16,14
067b6e53,438725,440525,3,6,1800,16,14
0ae4d124,438585,440885,4,10,2300,16,14
025dca15,438735,441245,5,2,2510,16,14
07b85c8d,539095,539475,13,7,380,16,14
0511bf56,539895,540435,6,5,540,16,14
0cd23588,539395,540805,8,12,1410,16,14
0a403ad0,539955,541255,0,10,1300,16,14
00535245,1025,1455,5,0,430,3,10
0895e818,12065,12505,7,8,440,3,10
08056632,12155,13275,2,8,1120,3,10
0297b0d6,23055,23485,6,2,430,3,10
05f998d6,23095,24015,6,5,920,3,10
02284657,34025,34565,0,2,540,3,10
06457ed3,34415,34925,1,6,510,3,10
00752121,34115,35285,2,0,1170,3,10
04724c60,34635,35645,3,4,1010,3,10
043f1767,34265,36365,5,4,2100,3,10
093d2aa1,34735,36735,7,9,2000,3,10
063e3016,34175,37095,8,6,2920,3,10
01dcd3d4,34355,37455,9,1,3100,3,10
07df78c5,34445,37815,0,7,3370,3,10
027cd0d1,34215,38305,8,2,4090,3,10
07de9f91,34535,38665,9,7,4130,3,10
05069f20,135005,135385,0,5,380,3,10
09a4ec51,135005,135745,1,9,740,3,10
06b582d6,135005,136105,6,6,1100,3,10
013870a1,135005,136465,1,1,1460,3,10
033b8132,135005,137185,2,3,2180,3,10
06fdd6b0,135005,137545,0,6,2540,3,10
0163eae4,135005,137905,4,1,2900,3,10
05449234,135005,138265,4,5,3260,3,10
09272775,135005,138625,5,9,3620,3,10
024b3417,337065,337495,7,2,430,3,10
02e618a3,337055,337945,3,2,890,3,10
04b34d85,438025,438475,5,4,450,3,10
0450deb7,539065,539555,7,4,490,3,10
02535249,1025,1535,9,2,510,4,10
0195e812,12095,12525,8,1,430,4,10
044d6095,23105,23665,5,4,560,4,10
0297b0d5,23265,24195,5,2,930,4,10
03dcd3d4,34335,34835,6,3,500,4,10
023f1765,34255,35195,7,2,940,4,10
06784c50,34575,35555,8,6,980,4,10
06f62638,35255,35915,9,6,660,4,10
02f998d4,34045,36275,0,2,2230,4,10
063e3016,34145,36635,1,6,2490,4,10
05a4ec59,34985,36995,2,5,2010,4,10
037cd0d2,34185,37715,4,3,3530,4,10
013d2aa2,34595,38075,5,1,3480,4,10
043870a8,35295,38445,7,4,3150,4,10
05845aa1,35365,38805,8,5,3440,4,10
05449230,35835,39165,9,5,3330,4,10
0107ae82,34895,39525,0,1,4630,4,10
02696ce8,34825,39885,1,2,5060,4,10
06b34d89,36185,40245,2,6,4060,4,10
02e28bd7,35105,40605,3,2,5500,4,10
082d6127,34715,40965,4,8,6250,4,10
0962ad54,35595,41325,5,9,5730,4,10
00421202,35345,41695,7,0,6350,4,10
05845aa1,35365,42055,8,5,6690,4,10
0279a0b0,36755,42415,9,2,5660,4,10
0107ae82,34895,42775,0,1,7880,4,10
02696ce8,34825,43135,1,2,8310,4,10
045fb4c0,135005,135385,0,4,380,4,10
00d60b70,135005,135745,0,0,740,4,10
08e37891,135005,136105,1,8,1100,4,10
077fc517,135005,136465,7,7,1460,4,10
097edc86,135005,136825,6,9,1820,4,10
015007e7,135005,137185,7,1,2180,4,10
01bf6d31,135005,137545,1,1,2540,4,10
02b4b493,135005,137905,3,2,2900,4,10
07f38868,135005,138265,8,7,3260,4,10
05a4b155,135005,138625,5,5,3620,4,10
06bb4a30,337145,337555,0,6,410,4,10
08dbc262,337055,337925,2,8,870,4,10
02617733,337065,338285,3,2,1220,4,10
0290d444,539225,539655,4,2,430,4,10
098565f7,539205,540045,7,9,840,4,10
0395e811,12105,12485,0,3,380,12,4
03056633,12235,12845,1,3,610,12,4
03284653,12355,13205,2,3,850,12,4
03f998d0,12305,13925,0,3,1620,12,4
01df78c0,23415,23895,0,1,480,12,4
02de9f91,34105,34505,1,2,400,12,4
00724c60,34135,35225,3,0,1090,12,4
02cdb8f1,34525,35585,0,2,1060,12,4
00272770,34415,35945,1,0,1530,12,4
00a4ec52,34725,36305,2,0,1580,12,4
033870a0,35135,37025,0,3,1890,12,4
02f62633,35095,37385,1,2,2290,12,4
00a4b151,135005,135385,1,0,380,12,4
03421201,135005,135745,1,3,740,12,4
00572cf3,135005,136105,3,0,1100,12,4
02d945c0,135005,136825,0,2,1820,12,4
0363eae2,135005,137185,2,3,2180,12,4
00a12892,135005,137545,2,0,2540,12,4
036333a2,135005,137905,2,3,2900,12,4
0133ed00,337035,337435,0,1,400,12,4
027fc511,337205,337795,1,2,590,12,4
00ccec21,337405,338885,1,0,1480,12,4
03cdb122,337635,339245,2,3,1610,12,4
022ed3d0,337575,339615,0,2,2040,12,4
0192f853,438215,438625,3,1,410,12,4
03bf6d30,438155,438985,0,3,830,12,4
00563581,438605,439345,1,0,740,12,4
01488782,438245,439705,2,1,1460,12,4
03b4b490,438385,440075,0,3,1690,12,4
01caf2a2,438505,440445,2,1,1940,12,4
02dbc263,539265,540095,3,2,830,12,4
02617730,539345,540455,0,2,1110,12,4
03535242,1095,1695,2,3,600,7,13
0c95e810,12105,12485,4,12,380,7,13
0cf998da,12335,12845,5,12,510,7,13
0c4d6095,12165,13215,7,12,1050,7,13
0c97b0d6,12235,14015,1,12,1780,7,13
0c75212a,12445,14375,2,12,1930,7,13
0c28465a,12395,14945,1,12,2550,7,13
0c3e3011,23075,23685,1,12,610,7,13
0adcd3d1,23305,24275,1,10,970,7,13
0a457ed5,34095,34645,12,10,550,7,13
09724c67,34215,35005,0,9,790,7,13
08de9f92,34175,35365,1,8,1190,7,13
07df78c7,34135,35725,2,7,1590,7,13
003d2aa1,34345,36085,3,0,1740,7,13
0a421204,35215,36445,4,10,1230,7,13
0827277b,34435,36805,5,8,2370,7,13
02726651,35005,37165,6,2,2160,7,13
06b582d1,34965,37535,8,6,2570,7,13
02845aa4,35235,38255,10,2,3020,7,13
053870ab,35125,38615,11,5,3490,7,13
07696cea,34685,38975,12,7,4290,7,13
0803e96b,35355,39335,0,8,3980,7,13
09b22806,35155,39695,1,9,4540,7,13
09ff7e56,34425,40055,2,9,5630,7,13
07f62637,35105,40415,3,7,5310,7,13
0be618a6,36015,40785,5,11,4770,7,13
003b8131,35405,41145,6,0,5740,7,13
0b14c3cb,35935,41515,8,11,5580,7,13
0062ad50,35545,41875,9,0,6330,7,13
040f3789,36235,42245,11,4,6010,7,13
0730aca0,35865,42605,12,7,6740,7,13
024b3418,36075,42965,0,2,6890,7,13
007d6539,35475,43325,1,0,7850,7,13
049650aa,35805,43685,2,4,7880,7,13
04b34d87,36155,44045,3,4,7890,7,13
02fb9b66,135005,135385,6,2,380,7,13
0850deb4,135005,135745,4,8,740,7,13
0a7be719,135005,136105,9,10,1100,7,13
0c99bf10,135005,136465,0,12,1460,7,13
09d60b79,135005,136825,9,9,1820,7,13
07ec0d74,135005,137185,4,7,2180,7,13
032ed3d1,135005,137545,1,3,2540,7,13
0b92f858,135005,137905,8,11,2900,7,13
0af3886a,135005,138265,10,10,3260,7,13
0b9a82f9,135005,138625,9,11,3620,7,13
058db5ab,135005,138985,11,5,3980,7,13
03119799,135005,139345,9,3,4340,7,13
07ebc9aa,135005,139705,10,7,4700,7,13
0965d939,135005,140065,9,9,5060,7,13
07fdd2aa,135005,140425,10,7,5420,7,13
053327e2,135005,140785,2,5,5780,7,13
039a18f4,135005,141145,4,3,6140,7,13
05e3249a,135005,141505,10,5,6500,7,13
027edc85,135005,141865,5,2,6860,7,13
0828f1f7,135005,142225,7,8,7220,7,13
0bcaf2a0,135005,142585,0,11,7580,7,13
06617731,135005,142945,1,6,7940,7,13
0cae2b59,135005,143665,9,12,8660,7,13
01fcf0e0,135005,144025,0,1,9020,7,13
09976671,135005,144385,1,9,9380,7,13
025e2767,337085,337495,7,2,410,7,13
074266d8,337025,337855,8,7,830,7,13
08b49ca9,337165,338215,9,8,1050,7,13
03371951,337285,338645,1,3,1360,7,13
0372db62,337185,339005,2,3,1820,7,13
0149b048,438185,438695,8,1,510,7,13
04261f70,438195,439125,0,4,930,7,13
02807691,438215,439485,1,2,1270,7,13
060042da,539235,540245,10,6,1010,7,13
0a53524d,1075,1515,13,10,440,3,15
0795e816,12045,12465,10,7,420,3,15
074d6093,12085,12935,2,7,850,3,15
07056633,12125,13345,6,7,1220,3,15
0297b0dc,23015,23505,12,2,490,3,15
0728465c,23145,24135,12,7,990,3,15
0b752126,34035,34505,12,11,470,3,15
08457edc,34425,34865,13,8,440,3,15
0e7cd0da,34205,35235,0,14,1030,3,15
0d3f176d,34295,35625,3,13,1330,3,15
0cff7e58,34795,35985,4,12,1190,3,15
0cb22808,35475,36345,5,12,870,3,15
053d2aa5,34785,37425,8,5,2640,3,15
04784c50,34735,37785,9,4,3050,3,15
00df78cd,34525,38145,10,0,3620,3,15
05dcd3d3,34335,38515,12,5,4180,3,15
06de9f97,34615,38875,13,6,4260,3,15
03696ce0,35095,39235,14,3,4140,3,15
08272770,34885,39595,0,8,4710,3,15
0c9650ac,36265,39955,1,12,3690,3,15
0cb582d0,35315,40315,2,12,5000,3,15
0562ad51,35945,40685,4,5,4740,3,15
0374a025,36005,41045,5,3,5040,3,15
02572cf9,36155,41405,6,2,5250,3,15
00069f23,35015,41765,7,0,6750,3,15
0a449231,36215,42135,9,10,5920,3,15
05726659,35335,42495,10,5,7160,3,15
01724c6e,34715,42865,12,1,8150,3,15
09cdb8f6,34995,43225,13,9,8230,3,15
0d7d6536,35885,43585,14,13,7700,3,15
0ee28bd7,35295,43945,0,14,8650,3,15
013327ec,135005,135385,12,1,380,3,15
01c4bd99,135005,135745,9,1,740,3,15
001559f3,135005,136105,3,0,1100,3,15
00d60b7b,135005,136465,11,0,1460,3,15
08bc05b7,135005,136825,7,8,1820,3,15
0233ed04,135005,137185,4,2,2180,3,15
0e12f961,135005,137545,1,14,2540,3,15
087edc88,135005,137905,8,8,2900,3,15
058bdf28,135005,138625,8,5,3620,3,15
04b34d8b,135005,138985,11,4,3980,3,15
0850deba,135005,139345,10,8,4340,3,15
0c513aee,135005,139705,14,12,4700,3,15
0879a0bb,135005,140065,11,8,5060,3,15
0b2554f6,135005,140425,6,11,5420,3,15
0d28f1f7,337055,337495,7,13,440,3,15
01bf6d34,337075,338065,4,1,990,3,15
0e92f854,438095,438525,4,14,430,3,15
08a595be,539065,539695,14,8,630,3,15
01535242,1025,1595,2,1,570,4,10
0395e815,12025,12465,5,3,440,4,10
034d6093,12105,12875,9,3,770,4,10
03056634,12195,13265,2,3,1070,4,10
0397b0d4,12295,13795,2,3,1500,4,10
09f998d2,23055,23605,2,9,550,4,10
07752122,23095,24135,2,7,1040,4,10
073e3017,34045,34585,1,7,540,4,10
06df78c8,34355,34945,2,6,590,4,10
047cd0d8,34115,35305,3,4,1190,4,10
01ccc9d0,35515,36025,5,1,510,4,10
02272779,34595,36385,6,2,1790,4,10
03784c54,34435,36745,7,3,2310,4,10
01696ce4,34805,37105,8,1,2300,4,10
06cdb8f9,34725,37465,9,6,2740,4,10
07457ed5,34275,37825,0,7,3550,4,10
06724c64,34415,38185,1,6,3770,4,10
03e28bd4,35045,38545,2,3,3500,4,10
06a4ec53,34975,38905,3,6,3930,4,10
0507ae88,34885,39265,4,5,4380,4,10
05449232,36175,39985,6,5,3810,4,10
014b3418,36515,40345,7,1,3830,4,10
0474a025,35975,40705,8,4,4730,4,10
07b22803,35335,41065,9,7,5730,4,10
05c380d6,35755,41425,0,5,5670,4,10
06845aa1,35495,41785,1,6,6290,4,10
037d6538,35825,42145,2,3,6320,4,10
06a4ec53,34975,42505,3,6,7530,4,10
0530aca3,36285,42865,4,5,6580,4,10
06513ae0,135005,135385,0,6,380,4,10
007be715,135005,135745,5,0,740,4,10
096333a5,135005,136105,5,9,1100,4,10
05c4bd97,135005,136465,7,5,1460,4,10
039a18f9,135005,136825,9,3,1820,4,10
09d945c9,135005,137185,9,9,2180,4,10
0233ed05,135005,137545,5,2,2540,4,10
06d7f0c5,135005,137905,5,6,2900,4,10
052ed3d7,135005,138265,7,5,3260,4,10
06a12895,135005,138625,5,6,3620,4,10
079e7392,337065,337595,2,7,530,4,10
0928f1f2,337155,338125,2,9,970,4,10
0292f858,539175,539685,8,2,510,4,10
02535240,1075,1495,0,2,420,11,3
01284650,12215,12765,2,1,550,11,3
01056630,12065,13125,0,1,1060,11,3
01f998d0,12165,13515,0,1,1350,11,3
00752122,23025,23425,2,0,400,11,3
017cd0d2,23065,23815,2,1,750,11,3
01df78c0,135005,135385,0,1,380,11,3
0207ae82,135005,135745,2,2,740,11,3
01ccc9d0,135005,136105,0,1,1100,11,3
02421201,135005,136825,1,2,1820,11,3
00fe91d2,135005,137185,2,0,2180,11,3
01b34d82,337105,337855,2,1,750,11,3
02a12890,337215,338215,0,2,1000,11,3
00513ae1,337395,338575,1,0,1180,11,3
00502bc2,337495,338935,2,0,1440,11,3
0279a0b1,438165,438605,1,2,440,11,3
017be712,438255,438965,2,1,710,11,3
02241851,438275,439335,1,2,1060,11,3
012554f0,539075,539455,0,1,380,11,3
001559f2,539775,540165,2,0,390,11,3
025fb4c0,539705,540525,0,2,820,11,3
00c4bd91,539515,540885,1,0,1370,11,3
01535243,1075,1495,3,1,420,8,9
03056635,12175,12605,8,3,430,8,9
0395e818,12095,12965,0,3,870,8,9
034d6093,12165,13375,4,3,1210,8,9
03f998d6,12295,13885,4,3,1590,8,9
00284657,23045,23585,7,0,540,8,9
087cd0d7,23245,24095,7,8,850,8,9
053f1763,34105,34525,4,5,420,8,9
05dcd3d0,34155,34935,8,5,780,8,9
01df78c1,34255,35295,0,1,1040,8,9
04457ed0,34225,35655,1,4,1430,8,9
05724c62,34415,36145,0,5,1730,8,9
02de9f94,34335,36505,1,2,2170,8,9
065fb4c7,135005,135745,7,6,740,8,9
01e37898,135005,136105,8,1,1100,8,9
083d2aa2,135005,136465,2,8,1460,8,9
04a4ec57,135005,136825,7,4,1820,8,9
07421203,135005,137185,3,7,2180,8,9
0462ad54,135005,137545,4,4,2540,8,9
0514c3c4,135005,137905,4,5,2900,8,9
08265b68,135005,138265,8,8,3260,8,9
08c4bd93,135005,138625,3,8,3620,8,9
06d945c4,135005,138985,4,6,3980,8,9
01d7f0c0,135005,139345,0,1,4340,8,9
05696ce2,135005,139705,2,5,4700,8,9
023870a0,135005,140065,0,2,5060,8,9
037d6538,135005,140425,8,3,5420,8,9
089650a4,135005,140785,4,8,5780,8,9
06a12890,135005,141145,0,6,6140,8,9
037be710,135005,141505,0,3,6500,8,9
0828f1f3,337105,337595,3,8,490,8,9
07488788,337325,338025,8,7,700,8,9
0692f851,337225,338395,1,6,1170,8,9
01a595b3,337415,338765,3,1,1350,8,9
00caf2a3,438185,438595,3,0,410,8,9
05563584,438285,438955,4,5,670,8,9
022ae3f5,438115,439315,5,2,1200,8,9
05f38860,438375,439725,0,5,1350,8,9
03599fa6,539175,539645,6,3,470,8,9
014d6091,12165,12835,0,1,670,13,2
01752120,12445,13555,0,1,1110,13,2
00dcd3d1,23085,23465,1,0,380,13,2
003d2aa1,23465,23845,1,0,380,13,2
01f62630,34445,35205,0,1,760,13,2
00c380d1,34845,35565,1,0,720,13,2
00bf9c61,135005,135385,1,0,380,13,2
014569f0,337065,337445,0,1,380,13,2
00d945c1,337115,337805,1,0,690,13,2
01e37890,438045,438435,0,1,390,13,2
0033ed01,438165,439175,1,0,1010,13,2
00ec0d71,539035,539425,1,0,390,13,2
01535240,1065,1475,0,1,410,10,2
0095e810,12075,12465,1,0,390,10,2
0097b0d0,12205,13185,1,0,980,10,2
00284651,23025,23425,1,0,400,10,2
01724c61,34085,34785,0,1,700,10,2
00cdb8f0,34385,35145,1,0,760,10,2
01696ce1,34575,35505,0,1,930,10,2
013b8131,35385,36225,0,1,840,10,2
013b8131,35385,36945,0,1,1560,10,2
013b8131,35385,37665,0,1,2280,10,2
01265b61,135005,135745,1,1,740,10,2
009a18f0,135005,136105,0,0,1100,10,2
012554f0,135005,136465,0,1,1460,10,2
00e37891,337075,337455,1,0,380,10,2
007fc511,337375,338175,1,0,800,10,2
0112f960,337425,338535,0,1,1110,10,2
01ccec20,438115,438855,0,1,740,10,2
015007e0,539245,539635,0,1,390,10,2
03535241,1085,1575,1,3,490,11,6
0295e813,12035,12445,0,2,410,11,6
02056633,12165,13175,3,2,1010,11,6
0297b0d0,23105,23565,0,2,460,11,6
043e3010,23305,24015,0,4,710,11,6
04dcd3d0,34175,34885,5,4,710,11,6
003f1762,34115,35255,1,0,1140,11,6
05df78c0,34265,35615,2,5,1350,11,6
04b582d4,35155,35975,3,4,820,11,6
02784c50,34485,36335,4,2,1850,11,6
04726654,35225,36695,5,4,1470,11,6
038495c5,35025,37775,2,3,2750,11,6
04421200,35575,38135,3,4,2560,11,6
02c380d5,35965,38495,4,2,2530,11,6
0430aca2,36465,38855,5,4,2390,11,6
01265b64,36965,39215,0,1,2250,11,6
00bf9c64,37065,39935,2,0,2870,11,6
05513ae3,37105,40295,3,5,3190,11,6
054b3414,36755,40655,4,5,3900,11,6
01fdd2a2,37215,41015,5,1,3800,11,6
0028f1f2,135005,135385,2,0,380,11,6
01ff29c2,135005,135745,2,1,740,11,6
057be712,135005,136465,2,5,1460,11,6
001559f5,135005,136825,5,0,1820,11,6
037fc512,135005,137185,2,3,2180,11,6
01f38864,135005,137545,4,1,2540,11,6
018fdf72,135005,137905,2,1,2900,11,6
05307620,135005,138625,0,5,3620,11,6
0033ed01,135005,138985,1,0,3980,11,6
015816d4,135005,139345,4,1,4340,11,6
0590b2a2,337105,337515,2,5,410,11,6
016adab4,337185,338235,4,1,1050,11,6
03fcf0e5,337205,338595,5,3,1390,11,6
01ebc9a3,337345,339005,3,1,1660,11,6
03f72fd5,337445,339375,5,3,1930,11,6
04976673,438215,438625,3,4,410,11,6
05e8a384,438275,438985,4,5,710,11,6
021340a5,438245,439345,5,2,1100,11,6
00187793,438295,439755,3,0,1460,11,6
037ca595,539305,539755,5,3,450,11,6
0153524c,1015,1495,12,1,480,6,15
0c95e81e,12045,12545,14,12,500,6,15
094d6090,23065,23565,0,9,500,6,15
0b056630,23105,24195,0,11,1090,6,15
09f998dd,34115,34545,14,9,430,6,15
09752127,34245,34905,0,9,660,6,15
033f1763,34395,35265,1,3,870,6,15
0cff7e53,35015,35625,2,12,610,6,15
003870aa,35715,36345,4,0,630,6,15
02284654,34185,36705,5,2,2520,6,15
003d2aa1,34935,37075,7,0,2140,6,15
0bccc9d1,36055,37435,8,11,1380,6,15
0727277c,35055,37795,9,7,2740,6,15
03df78cd,34575,38155,10,3,3580,6,15
00fdd6be,36305,38515,11,0,2210,6,15
0a2d612d,35135,38875,12,10,3740,6,15
0a457ed6,34535,39235,13,10,4700,6,15
04dcd3dc,34465,39595,14,4,5130,6,15
08784c59,34855,39955,0,8,5100,6,15
08421201,35875,40675,2,8,4800,6,15
06de9f96,34665,41035,3,6,6370,6,15
0a3b8134,36125,41395,4,10,5270,6,15
03572cf9,36475,41755,5,3,5280,6,15
0362ad51,36355,42125,7,3,5770,6,15
0730aca3,36665,42555,12,7,5890,6,15
029650a4,36615,42915,13,2,6300,6,15
0ce28bde,35525,43275,14,12,7750,6,15
0463eae0,36445,43635,0,4,7190,6,15
0314c3c4,36695,43995,1,3,7300,6,15
0e8bdf22,36795,44355,2,14,7560,6,15
0cfe91d4,36455,44715,3,12,8260,6,15
07ccec2b,135005,135385,11,7,380,6,15
015816da,135005,135745,10,1,740,6,15
0ca595ba,135005,136105,10,12,1100,6,15
0ba0c8ea,135005,136465,10,11,1460,6,15
0c91ae66,135005,137185,6,12,2180,6,15
06ae2b5a,135005,137545,10,6,2540,6,15
006adaba,135005,137905,10,0,2900,6,15
0deed567,135005,138265,7,13,3260,6,15
064b3410,135005,138625,0,6,3620,6,15
04bf9c67,135005,138985,7,4,3980,6,15
0c24185a,135005,139345,10,12,4340,6,15
0499bf19,135005,139705,9,4,4700,6,15
0bda9f88,135005,140065,8,11,5060,6,15
0ae32494,135005,140425,4,10,5420,6,15
00cdb127,135005,140785,7,0,5780,6,15
0592f851,135005,141145,1,5,6140,6,15
0956358b,135005,141505,11,9,6500,6,15
0a617732,135005,141865,2,10,6860,6,15
0d8fdf7b,135005,142225,11,13,7220,6,15
0836cda5,135005,142585,5,8,7580,6,15
0440cd05,135005,142945,5,4,7940,6,15
0cf72fdc,135005,143305,12,12,8300,6,15
04fb9b69,135005,143665,9,4,8660,6,15
0850deba,135005,144025,10,8,9020,6,15
043327e8,135005,144745,8,4,9740,6,15
051559fb,135005,145105,11,5,10100,6,15
07bc05bb,135005,145465,11,7,10460,6,15
0312f960,135005,145825,0,3,10820,6,15
054bf94a,337125,337555,10,5,430,6,15
0365d93b,337205,337915,11,3,710,6,15
03bc4b8e,337095,338305,14,3,1210,6,15
037ca596,438195,438665,6,3,470,6,15
04cde4dd,438325,439135,13,4,810,6,15
0637195c,539365,539955,12,6,590,6,15
034266d1,539185,540365,1,3,1180,6,15
0553524b,1095,1535,11,5,440,10,16
0e05663e,12155,12625,15,14,470,10,16
0e4d6096,12145,12995,1,14,850,10,16
0e95e819,12065,13405,5,14,1340,10,16
0e97b0d3,12165,13795,8,14,1630,10,16
0ef998d8,12235,14165,10,14,1930,10,16
0228465c,23075,23565,12,2,490,10,16
0adf78cc,23555,24215,12,10,660,10,16
07724c6c,23665,24865,12,7,1200,10,16
00784c53,34055,34465,7,0,410,10,16
003d2aa1,34145,34835,9,0,690,10,16
08a4ec5a,34465,35195,10,8,730,10,16
0af62633,34605,35555,11,10,950,10,16
00cdb8f1,34305,35915,12,0,1610,10,16
003b8136,34935,36275,13,0,1340,10,16
0d2d6128,34255,36665,0,13,2410,10,16
0c62ad5a,35135,37025,1,12,1890,10,16
0f069f23,34345,37385,2,15,3040,10,16
0f99bf12,36875,37745,3,15,870,10,16
09ff7e5b,34185,38105,4,9,3920,10,16
0de28bdd,34555,38465,5,13,3910,10,16
0f07ae8e,34455,38825,6,15,4370,10,16
0f845aa8,34785,39185,7,15,4400,10,16
048bdf27,35655,39545,8,4,3890,10,16
0b42120b,34735,39905,9,11,5170,10,16
0d63eaec,35255,40625,11,13,5370,10,16
030f3787,35975,40985,12,3,5010,10,16
0ae618a5,35735,41345,13,10,5610,10,16
061559f6,37165,41705,14,6,4540,10,16
08fe91d3,35355,42075,0,8,6720,10,16
08bf9c6f,36105,42435,1,8,6330,10,16
06da9f87,37265,42795,2,6,5530,10,16
0e14c3c2,35615,43165,4,14,7550,10,16
0f03e96a,34915,43525,5,15,8610,10,16
086333a7,36655,43885,6,8,7230,10,16
0fbc05bc,37425,44245,7,15,6820,10,16
0e5fb4cc,37085,44605,8,14,7520,10,16
0c3327e6,36735,44975,10,12,8240,10,16
01c603b3,36585,45695,12,1,9110,10,16
054569fb,37295,46065,14,5,8770,10,16
0630762d,37055,46435,0,6,9380,10,16
05d945c0,37355,46795,1,5,9440,10,16
009a82fe,135005,135385,14,0,380,10,16
0f36cda8,135005,135745,8,15,740,10,16
02daddc2,135005,136105,2,2,1100,10,16
0f18779e,135005,136465,14,15,1460,10,16
005e2764,135005,136825,4,0,1820,10,16
0fcd928d,135005,137185,13,15,2180,10,16
0a408daf,135005,137545,15,10,2540,10,16
00000b9b,135005,137905,11,0,2900,10,16
0aa9b7e5,135005,138265,5,10,3260,10,16
09c59f59,135005,138625,9,9,3620,10,16
0c8d14e6,135005,138985,6,12,3980,10,16
035ff9ea,135005,139345,10,3,4340,10,16
046abc4c,135005,139705,12,4,4700,10,16
0ae3249a,135005,140065,10,10,5060,10,16
0ecdb12e,135005,140425,14,14,5420,10,16
072ae3f9,135005,140785,9,7,5780,10,16
05fc1290,135005,141145,0,5,6140,10,16
006adab9,135005,141505,9,0,6500,10,16
06fb9b66,135005,141865,6,6,6860,10,16
010b7d9e,135005,142225,14,1,7220,10,16
0aebab4f,135005,142585,15,10,7580,10,16
0b7901cc,135005,142945,12,11,7940,10,16
02e05d5f,135005,143305,15,2,8300,10,16
01157862,135005,143665,2,1,8660,10,16
0e791865,135005,144025,5,14,9020,10,16
042e6ec4,135005,144385,4,4,9380,10,16
00bddb6b,135005,145105,11,0,10100,10,16
0e521322,135005,145465,2,14,10460,10,16
0525a775,135005,145825,5,5,10820,10,16
0ba595ba,135005,146185,10,11,11180,10,16
0661773d,135005,146545,13,6,11540,10,16
0a3cfca7,337095,337495,7,10,400,10,16
09879a97,337155,338145,7,9,990,10,16
0f5a98ec,539075,539665,12,15,590,10,16
01535242,1005,1395,2,1,390,5,5
02f998d3,12225,12785,4,2,560,5,5
024d6093,12085,13145,0,2,1060,5,5
0297b0d4,12155,13905,0,2,1750,5,5
02284651,23035,23485,1,2,450,5,5
003f1761,23195,23915,1,0,720,5,5
02df78c0,34045,34825,1,2,780,5,5
01784c53,34255,35185,2,1,930,5,5
00ff7e51,34335,35545,3,0,1210,5,5
013d2aa0,34305,35915,0,1,1610,5,5
02cdb8f0,34585,36275,1,2,1690,5,5
00b582d4,35145,36635,2,0,1490,5,5
00726653,35185,36995,3,0,1810,5,5
00845aa4,35565,37355,4,0,1790,5,5
0207ae83,34835,37715,0,2,2880,5,5
03a4ec53,34925,38075,1,3,3150,5,5
043b8133,35725,38795,3,4,3070,5,5
034b3411,36415,39155,4,3,2740,5,5
0207ae83,34835,39515,0,2,4680,5,5
03a4ec53,34925,39875,1,3,4950,5,5
00241853,135005,135385,3,0,380,5,5
00a4b153,135005,135745,3,0,740,5,5
021559f0,135005,136105,0,2,1100,5,5
01d945c3,135005,136465,3,1,1460,5,5
036333a3,135005,137185,3,3,2180,5,5
03e32494,135005,138265,4,3,3260,5,5
0479a0b1,135005,138625,1,4,3620,5,5
03d7f0c2,337025,337405,2,3,380,5,5
01ccec20,337065,338135,0,1,1070,5,5
0325a771,337165,338495,1,3,1330,5,5
022ed3d1,539105,539575,1,2,470,5,5
00535241,1005,1415,1,0,410,7,2
0095e811,12095,12475,1,0,380,7,2
00056631,12215,13195,1,0,980,7,2
003f1761,23355,23845,1,0,490,7,2
01784c50,34315,35125,0,1,810,7,2
0007ae81,34775,35485,1,0,710,7,2
0007ae81,34775,36205,1,0,1430,7,2
01449231,135005,135745,1,1,740,7,2
01e618a0,135005,136465,0,1,1460,7,2
01c603b0,337095,337475,0,1,380,7,2
01a4b150,337175,338195,0,1,1020,7,2
00da9f81,438255,439245,1,0,990,7,2
06535241,1085,1575,1,6,490,12,10
0295e816,12055,12525,8,2,470,12,10
02056636,12245,12885,9,2,640,12,10
024d6099,12155,13255,1,2,1100,12,10
02f998d9,12405,13705,7,2,1300,12,10
0297b0d8,12315,14065,8,2,1750,12,10
08284650,23085,23565,0,8,480,12,10
09784c59,34175,34825,6,9,650,12,10
01b22808,34965,35545,8,1,580,12,10
06ff7e55,34255,36265,0,6,2010,12,10
03de9f94,34095,36625,1,3,2530,12,10
06a4ec51,34645,37345,3,6,2700,12,10
0007ae85,34555,37705,4,0,3150,12,10
083d2aa9,34235,38065,5,8,3830,12,10
04696ce9,34455,38425,6,4,3970,12,10
04845aa2,35075,38785,7,4,3710,12,10
009650a0,35885,39145,8,0,3260,12,10
03ccc9d0,35135,39505,9,3,4370,12,10
0663eae6,35605,39865,0,6,4260,12,10
05bf9c61,36635,40225,1,5,3590,12,10
0614c3c7,36075,40585,2,6,4510,12,10
027d6534,35415,40945,3,2,5530,12,10
000f3785,36445,41305,4,0,4860,12,10
0830aca5,35985,41665,5,8,5680,12,10
02b34d83,36345,42025,6,2,5680,12,10
0650deb9,36595,42385,7,6,5790,12,10
02a12895,36495,42745,8,2,6250,12,10
024b3410,36255,43105,9,2,6850,12,10
03265b64,36625,43465,0,3,6840,12,10
03307621,135005,135385,1,3,380,12,10
0928f1f3,135005,136105,3,9,1100,12,10
02599fa6,135005,136465,6,2,1460,12,10
00fc1290,135005,136825,0,0,1820,12,10
00daddc1,135005,137185,1,0,2180,12,10
024bf949,135005,137545,9,2,2540,12,10
0471a462,135005,137905,2,4,2900,12,10
067a6fd4,135005,138265,4,6,3260,12,10
08e32491,135005,138985,1,8,3980,12,10
095816d8,135005,139345,8,9,4340,12,10
04a0c8e1,135005,139705,1,4,4700,12,10
0591ae66,135005,140065,6,5,5060,12,10
086adab2,135005,140425,2,8,5420,12,10
0072db65,135005,141145,5,0,6140,12,10
097e4084,135005,141505,4,9,6500,12,10
0499bf16,135005,142225,6,4,7220,12,10
05e05d51,337035,337575,1,5,540,12,10
044f61a2,337065,337935,2,4,870,12,10
00737963,337335,338295,3,0,960,12,10
09000b94,337145,338655,4,9,1510,12,10
04921c05,337355,339015,5,4,1660,12,10
03761378,337235,339405,8,3,2170,12,10
0461ab62,337435,339815,2,4,2380,12,10
08f0fdc5,337535,340545,5,8,3010,12,10
07d2b792,438235,438625,2,7,390,12,10
008e4fa4,438335,438995,4,0,660,12,10
00409176,438455,439365,6,0,910,12,10
05791860,438585,439775,0,5,1190,12,10
03cee611,438385,440135,1,3,1750,12,10
03578a14,438535,440525,4,3,1990,12,10
06c42737,539495,540415,7,6,920,12,10
031b4988,539385,540775,8,3,1390,12,10
052e6ec9,539525,541135,9,5,1610,12,10
0c535241,1045,1655,1,12,610,10,16
0995e815,12035,12605,14,9,570,10,16
09284654,12335,12965,15,9,630,10,16
094d609d,12135,13325,0,9,1190,10,16
0905663e,12195,13715,3,9,1520,10,16
09f998d7,12315,14145,8,9,1830,10,16
093e3016,12455,14515,10,9,2060,10,16
0997b0d6,12295,14905,13,9,2610,10,16
09752123,12365,15455,8,9,3090,10,16
007cd0dc,23085,23565,12,0,480,10,16
08de9f9c,23305,24215,12,8,910,10,16
0c3d2aa6,34135,34515,9,12,380,10,16
07784c56,34085,35255,13,7,1170,10,16
06724c60,34015,35645,0,6,1630,10,16
042d6124,34235,36005,1,4,1770,10,16
0907ae88,34405,36375,3,9,1970,10,16
04a4ec53,34495,36865,11,4,2370,10,16
0d8495c3,34505,37295,0,13,2790,10,16
0bcdb8fd,34295,37655,1,11,3360,10,16
00bf9c62,135005,135385,2,0,380,10,16
0d3327ee,135005,135745,14,13,740,10,16
024569fd,135005,136105,13,2,1100,10,16
0fccec26,135005,136465,6,15,1460,10,16
09599fa4,135005,137185,4,9,2180,10,16
0291ae64,135005,137545,4,2,2540,10,16
0e40cd08,135005,137905,8,14,2900,10,16
0f976670,135005,138265,0,15,3260,10,16
03261f7d,135005,138985,13,3,3980,10,16
027a6fdb,135005,139345,11,2,4340,10,16
0aab35ee,135005,139705,14,10,4700,10,16
06b582db,135005,140065,11,6,5060,10,16
04c380de,135005,140425,14,4,5420,10,16
0a30aca7,135005,140785,7,10,5780,10,16
08da9f8b,135005,141505,11,8,6500,10,16
0212f960,135005,141865,0,2,6860,10,16
0c28f1f6,135005,142225,6,12,7220,10,16
06a0c8e8,135005,142585,8,6,7580,10,16
098fdf7b,135005,142945,11,9,7940,10,16
00119796,135005,143305,6,0,8300,10,16
0beed567,135005,143665,7,11,8660,10,16
00f2c047,135005,144025,7,0,9020,10,16
0e71a46c,135005,144385,12,14,9380,10,16
0e7e4080,135005,144745,0,14,9740,10,16
06504732,135005,145105,2,6,10100,10,16
0159f26f,135005,145465,15,1,10460,10,16
0f03e969,135005,145825,9,15,10820,10,16
0f449237,135005,146185,7,15,11180,10,16
0a50deb4,135005,146545,4,10,11540,10,16
08157867,337085,337495,7,8,410,10,16
07a9b7ed,337215,337945,13,7,730,10,16
0b3b6cf0,337365,338335,0,11,970,10,16
083ff781,337165,338695,1,8,1530,10,16
0ccee613,337545,339065,3,12,1520,10,16
00d2b796,337405,339455,6,0,2050,10,16
0fd80db1,337315,340005,1,15,2690,10,16
0c578a17,438065,438525,7,12,460,10,16
0f40917a,438035,438915,10,15,880,10,16
0439650d,539045,539655,13,4,610,10,16
07535242,1005,1515,2,7,510,13,8
0395e813,12095,12585,5,3,490,13,8
044d6093,23035,23545,3,4,510,13,8
023f1766,34495,35215,3,2,720,13,8
0297b0d2,34095,35575,4,2,1480,13,8
03284655,34265,35935,5,3,1670,13,8
02f998d1,34175,36295,6,2,2120,13,8
00069f26,35175,36655,7,0,1480,13,8
042d6127,35085,37025,1,4,1940,13,8
05784c51,34855,37385,2,5,2530,13,8
01724c66,34815,37745,3,1,2930,13,8
028495c6,35425,38105,4,2,2680,13,8
04e28bd2,35515,38465,5,4,2950,13,8
033b8133,35935,38825,6,3,2890,13,8
06b34d86,36995,39555,1,6,2560,13,8
0650deb0,37185,39915,2,6,2730,13,8
04241851,37505,40275,3,4,2770,13,8
01c603b3,37595,40635,4,1,3040,13,8
03fdd2a5,37305,40995,5,3,3690,13,8
072554f0,37535,41355,6,7,3820,13,8
014b3417,36895,41715,7,1,4820,13,8
04a12893,37145,42085,1,4,4940,13,8
07ff29c3,135005,135385,3,7,380,13,8
00ebc9a0,135005,136105,0,0,1100,13,8
05f2c045,135005,136465,5,5,1460,13,8
00807694,135005,136825,4,0,1820,13,8
033327e6,135005,137185,6,3,2180,13,8
00e37896,135005,137545,6,0,2540,13,8
065816d0,135005,137905,0,6,2900,13,8
0191ae62,135005,138265,2,1,3260,13,8
03fcf0e1,135005,138625,1,3,3620,13,8
044bf943,135005,138985,3,4,3980,13,8
0149b043,135005,139345,3,1,4340,13,8
007901c1,135005,139705,1,0,4700,13,8
02d945c1,135005,140065,1,2,5060,13,8
02cdb124,135005,140425,4,2,5420,13,8
045c4705,337055,337455,5,4,400,13,8
07199ba6,337235,337815,6,7,580,13,8
07504731,337135,338205,1,7,1070,13,8
04ab35e6,337275,338635,6,4,1360,13,8
05921c02,438465,438845,2,5,380,13,8
05761374,438375,439215,4,5,840,13,8
079837d6,438725,439585,6,7,860,13,8
0661ab67,438625,439945,7,6,1320,13,8
0359f260,438525,440305,0,3,1780,13,8
05d80db3,539185,539725,3,5,540,13,8
00535242,1075,1495,2,0,420,11,5
0195e814,12105,12545,4,1,440,11,5
01056632,12285,12905,0,1,620,11,5
014d6092,12195,13295,3,1,1100,11,5
01f998d4,12385,13655,4,1,1270,11,5
013e3011,12535,14015,0,1,1480,11,5
017cd0d1,12605,14405,3,1,1800,11,5
033f1762,23055,23505,2,3,450,11,5
04784c52,23515,23935,2,4,420,11,5
003d2aa3,34035,34445,4,0,410,11,5
02069f20,34315,34815,1,2,500,11,5
03272771,34195,35175,2,3,980,11,5
0207ae82,34385,35895,4,2,1510,11,5
048495c2,34475,36255,0,4,1780,11,5
03845aa0,34805,36615,1,3,1810,11,5
0062ad52,35175,36975,2,0,1800,11,5
029650a0,35485,37335,3,2,1850,11,5
00b34d82,35885,37695,4,0,1810,11,5
0250deb1,36035,38055,0,2,2020,11,5
02a12890,35995,38415,1,2,2420,11,5
038bdf20,35635,38775,2,3,3140,11,5
02a4b153,135005,135385,3,2,380,11,5
04bc05b0,135005,135745,0,4,740,11,5
022ed3d0,135005,136105,0,2,1100,11,5
02bf9c62,135005,136825,2,2,1820,11,5
004569f4,135005,137185,4,0,2180,11,5
037edc80,135005,137545,0,3,2540,11,5
02bb4a34,135005,138265,4,2,3260,11,5
036333a1,135005,138625,1,3,3620,11,5
0290d443,337125,337515,3,2,390,11,5
03292b34,337095,337875,4,3,780,11,5
008565f1,337115,338245,1,0,1130,11,5
048fdf72,337205,338605,2,4,1400,11,5
02fc1290,438265,438725,0,2,460,11,5
008db5a1,438195,439085,1,0,890,11,5
01ae2b52,438565,439445,2,1,880,11,5
0136cda4,438385,439815,4,1,1430,11,5
022e2ed1,438325,440185,1,2,1860,11,5
00fb6654,438465,440575,4,0,2110,11,5
00ebc9a3,539305,539795,3,0,490,11,5
00102c34,539385,540155,4,0,770,11,5
07535241,1055,1495,1,7,440,15,14
0b95e818,12085,12465,13,11,380,15,14
0b284653,12305,12825,0,11,520,15,14
0b3e3018,12405,13185,1,11,780,15,14
0bf998d5,12255,13595,5,11,1340,15,14
0b97b0da,12205,13955,6,11,1750,15,14
0b752125,12365,14325,8,11,1960,15,14
0b05663d,12155,14685,9,11,2530,15,14
003f176c,23035,23445,12,0,410,15,14
00de9f9c,23375,24055,12,0,680,15,14
0427277c,23635,24665,12,4,1030,15,14
022d6120,34085,34605,6,2,520,15,14
0d696ce0,34205,34975,8,13,770,15,14
02069f22,34165,35345,10,2,1180,15,14
04a4ec57,34385,35755,0,4,1370,15,14
058495c8,34405,36125,2,5,1720,15,14
0807ae83,34295,36485,3,8,2190,15,14
0de28bdd,34425,36845,4,13,2420,15,14
02cdb8f0,34125,37215,6,2,3090,15,14
0db582d5,34515,37765,3,13,3250,15,14
04c9c2e7,135005,135385,7,4,380,15,14
002e6ec4,135005,136465,4,0,1460,15,14
054e3c82,135005,136825,2,5,1820,15,14
07f62633,135005,137185,3,7,2180,15,14
09572cf5,135005,137545,5,9,2540,15,14
0a502bcc,135005,137905,12,10,2900,15,14
0a9a18fc,135005,138265,12,10,3260,15,14
0625a775,135005,138625,5,6,3620,15,14
04f38868,135005,138985,8,4,3980,15,14
04fc1296,135005,139345,6,4,4340,15,14
08102c3b,135005,139705,11,8,4700,15,14
0dab35e4,135005,140425,4,13,5420,15,14
09d80dbb,135005,140785,11,9,5780,15,14
0527b4b6,135005,141145,6,5,6140,15,14
07de6388,135005,141505,8,7,6500,15,14
08df5fa4,135005,141865,4,8,6860,15,14
0b63eae0,135005,142225,0,11,7220,15,14
04bf9c6a,135005,142585,10,4,7580,15,14
055fb4c9,135005,142945,9,5,7940,15,14
04ccec2c,135005,143305,12,4,8300,15,14
00caf2ab,135005,143665,11,0,8660,15,14
0891ae69,135005,144025,9,8,9020,15,14
01ebc9a2,135005,144385,2,1,9380,15,14
0d0042d0,135005,145105,0,13,10100,15,14
0d148754,337035,337435,4,13,400,15,14
0d5e7884,438145,438545,4,13,400,15,14
05dbf6b9,438115,438975,9,5,860,15,14
0bfb4aea,438205,439335,10,11,1130,15,14
049fdeca,539635,540185,10,4,550,15,14
029b0c20,539425,540595,0,2,1170,15,14
0095e812,12025,12485,2,0,460,16,9
004d6092,12115,12855,4,0,740,16,9
00056632,12165,13305,1,0,1140,16,9
0097b0d7,12185,13665,2,0,1480,16,9
01f998d5,23095,23545,5,1,450,16,9
07752125,23135,24055,5,7,920,16,9
063e3015,34035,34485,2,6,450,16,9
003f1768,34205,34845,3,0,640,16,9
07de9f91,34335,35205,4,7,870,16,9
07724c64,34355,35565,5,7,1210,16,9
02b582d7,35145,35935,7,2,790,16,9
02dcd3d7,34275,36295,8,2,2020,16,9
07784c53,34445,36655,0,7,2210,16,9
03457ed6,34285,37015,1,3,2730,16,9
063d2aa3,34485,37375,2,6,2890,16,9
088495c4,34975,37735,3,8,2760,16,9
06f62637,35315,38105,5,6,2790,16,9
02069f28,34735,38835,8,2,4100,16,9
07cdb8f2,34685,39195,0,7,4510,16,9
03b22802,35365,39915,2,3,4550,16,9
01845aa3,35475,40275,3,1,4800,16,9
08daddc3,135005,135385,3,8,380,16,9
05b69db5,135005,135745,5,5,740,16,9
03530c76,135005,136105,6,3,1100,16,9
0603e964,135005,136465,4,6,1460,16,9
074b3413,135005,136825,3,7,1820,16,9
083327e4,135005,137185,4,8,2180,16,9
07ec0d73,135005,137545,3,7,2540,16,9
08f2c048,135005,138625,8,8,3620,16,9
01cd9281,135005,138985,1,1,3980,16,9
028bdf25,135005,139705,5,2,4700,16,9
07c603b0,135005,140065,0,7,5060,16,9
00e32493,135005,140425,3,0,5420,16,9
0492f851,135005,140785,1,4,5780,16,9
068565f4,135005,141145,4,6,6140,16,9
076adab1,135005,141505,1,7,6500,16,9
0259f267,337095,337495,7,2,400,16,9
0461ab60,337145,337865,0,4,720,16,9
01157866,438195,439015,6,1,820,16,9
05d80db1,438415,439425,1,5,1010,16,9
04d2b796,539185,539565,6,4,380,16,9
061b4985,539775,540355,5,6,580,16,9
02c42737,539905,540725,7,2,820,16,9
04574c58,539685,541085,8,4,1400,16,9
03488351,539535,541455,1,3,1920,16,9
03535241,1075,1465,1,3,390,10,9
0595e814,12105,12525,4,5,420,10,9
054d6098,12185,12955,0,5,770,10,9
05056634,12235,13465,0,5,1230,10,9
0497b0d0,23095,23625,0,4,530,10,9
073f1760,23345,24135,0,7,790,10,9
07dcd3d0,34015,34395,6,7,380,10,9
08724c60,34225,34755,7,8,530,10,9
018495c6,34605,35125,0,1,520,10,9
00069f25,34485,35485,1,0,1000,10,9
06ff7e57,34345,35845,2,6,1500,10,9
04de9f90,34195,36205,3,4,2010,10,9
02df78c4,34095,36565,4,2,2470,10,9
08457ed3,34075,36925,5,8,2850,10,9
002d6121,34385,37285,6,0,2900,10,9
08a4ec53,34565,37645,7,8,3080,10,9
02e28bd7,34675,38035,1,2,3360,10,9
04f62633,34895,38405,3,4,3510,10,9
063870a6,34905,39125,5,6,4220,10,9
01421204,34985,39485,6,1,4500,10,9
0828f1f8,135005,135385,8,8,380,10,9
08a0c8e5,135005,135745,5,8,740,10,9
078fdf78,135005,136105,8,7,1100,10,9
0103e965,135005,136465,5,1,1460,10,9
07449231,135005,136825,1,7,1820,10,9
0850deb5,135005,137185,5,8,2180,10,9
05c603b2,135005,137545,2,5,2540,10,9
07da9f84,135005,137905,4,7,2900,10,9
0412f968,135005,138265,8,4,3260,10,9
04563581,135005,138625,1,4,3620,10,9
01ae2b50,135005,139345,0,1,4340,10,9
03fe91d8,135005,139705,8,3,4700,10,9
060f3780,135005,140065,0,6,5060,10,9
081559f1,135005,140785,1,8,5780,10,9
02ec0d78,135005,141145,8,2,6140,10,9
0790b2a2,337025,337405,2,7,380,10,9
076adab4,337045,337775,4,7,730,10,9
00eed566,337375,338145,6,0,770,10,9
00f72fd7,337335,338505,7,0,1170,10,9
07ebc9a2,337265,339255,2,7,1990,10,9
00187795,438215,438615,5,0,400,10,9
06e8a387,438185,438985,7,6,800,10,9
04bc4b88,438235,439345,8,4,1110,10,9
04fb9b60,438165,439705,0,4,1540,10,9
027ca596,539175,539645,6,2,470,10,9
02535243,1085,1615,3,2,530,11,15
0b95e819,12075,12545,14,11,470,11,15
0b4d6094,12085,12935,2,11,850,11,15
0bf998dc,12235,13485,13,11,1250,11,15
0b97b0dd,12215,13845,14,11,1630,11,15
05284652,23045,23605,2,5,560,11,15
00de9f92,23545,24235,2,0,690,11,15
013d2aab,34075,34485,11,1,410,11,15
06cdb8f5,34345,35365,7,6,1020,11,15
0bff7e52,34115,35725,8,11,1610,11,15
04272775,34145,36095,10,4,1950,11,15
0c2d612b,34245,36455,11,12,2210,11,15
077edc85,135005,135385,5,7,380,11,15
0ba595bd,135005,135745,13,11,740,11,15
0dbb4a38,135005,136105,8,13,1100,11,15
0136cda7,135005,136465,7,1,1460,11,15
0eebc9a1,135005,136825,1,14,1820,11,15
074bf940,135005,137185,0,7,2180,11,15
0e371951,135005,137545,1,14,2540,11,15
027e4080,135005,137905,0,2,2900,11,15
00199bad,135005,138265,13,0,3260,11,15
09696ce4,135005,138625,4,9,3620,11,15
0c50deb3,135005,139705,3,12,4700,11,15
096333ac,135005,140065,12,9,5060,11,15
034569f0,135005,140425,0,3,5420,11,15
0592f855,135005,140785,5,5,5780,11,15
0bdbc267,135005,141145,7,11,6140,11,15
0efc129b,135005,141505,11,14,6500,11,15
0bfcf0e5,135005,141865,5,11,6860,11,15
01187794,135005,142225,4,1,7220,11,15
09b49ca0,135005,142585,0,9,7580,11,15
09530c73,135005,142945,3,9,7940,11,15
065c470a,135005,143305,10,6,8300,11,15
0759f269,135005,143665,9,7,8660,11,15
03b22808,135005,144025,8,3,9020,11,15
0363eaeb,135005,144385,11,3,9380,11,15
092554f7,135005,145105,7,9,10100,11,15
0dda9f87,135005,145465,7,13,10460,11,15
02d7f0cd,135005,145825,13,2,10820,11,15
013b6cfa,337105,337555,10,1,450,11,15
06d2b798,438065,438575,8,6,510,11,15
0a8e4fa0,438095,439045,0,10,950,11,15
01578a1e,539225,539855,14,1,630,11,15
0495e811,12025,12425,3,4,400,1,5
0097b0d3,34115,34495,1,0,380,1,5
03056630,34045,34855,2,3,810,1,5
02752120,135005,135385,0,2,380,1,5
033e3011,135005,135745,1,3,740,1,5
027cd0d3,135005,136105,3,2,1100,1,5
013f1764,135005,136465,4,1,1460,1,5
01284651,135005,136825,1,1,1820,1,5
01457ed3,337105,337515,3,1,410,1,5
01df78c3,539075,539485,3,1,410,1,5
0495e813,12055,12505,1,4,450,15,7
04284650,12395,12875,3,4,480,15,7
04f998d6,12305,13595,5,4,1290,15,7
0497b0d0,12205,13955,6,4,1750,15,7
043e3013,12455,14315,0,4,1860,15,7
044d6091,12125,14675,1,4,2550,15,7
04de9f94,12895,15045,3,4,2150,15,7
043f1764,12585,15775,6,4,3190,15,7
04724c66,12915,16135,0,4,3220,15,7
053d2aa6,23105,23475,6,5,370,15,7
00696ce6,23475,23945,6,0,470,15,7
02b582d3,34205,35195,1,2,990,15,7
04f62631,34315,35555,2,4,1240,15,7
01e28bd4,34135,36275,4,1,2140,15,7
02a4ec51,34085,36635,5,2,2550,15,7
02ccc9d6,34625,36995,6,2,2370,15,7
037d6530,34825,37355,0,3,2530,15,7
0230aca0,35235,37715,1,2,2480,15,7
034b3416,35445,38075,2,3,2630,15,7
0079a0b3,36125,38795,4,0,2670,15,7
00513ae6,35915,39515,6,0,3600,15,7
016333a5,36245,39875,0,1,3630,15,7
0299bf12,36455,40235,1,2,3780,15,7
067be716,36135,40605,3,6,4470,15,7
013327e0,36315,40965,4,1,4650,15,7
002ae3f1,135005,135385,1,0,380,15,7
05daddc2,135005,136105,2,5,1100,15,7
037ca590,135005,136465,0,3,1460,15,7
05cd9285,135005,136825,5,5,1820,15,7
05307620,135005,137185,0,5,2180,15,7
06d7f0c2,135005,137545,2,6,2540,15,7
0390d443,135005,137905,3,3,2900,15,7
006adab2,135005,138265,2,0,3260,15,7
02ebab41,135005,138985,1,2,3980,15,7
047fc514,135005,139705,4,4,4700,15,7
02a595b1,135005,140065,1,2,5060,15,7
05f0fdc3,337045,337425,3,5,380,15,7
01d80db4,337365,337785,4,1,420,15,7
02157866,337105,338155,6,2,1050,15,7
033b6cf0,337375,338515,0,3,1140,15,7
033ff781,337185,338875,1,3,1690,15,7
06cee612,337495,339235,2,6,1740,15,7
05396504,337755,339605,4,5,1850,15,7
02c59f51,337765,340345,1,2,2580,15,7
01791862,337715,340705,2,1,2990,15,7
00574c55,438145,438605,5,0,460,15,7
02175c16,438115,438965,6,2,850,15,7
001b4981,438205,439335,1,0,1130,15,7
06c42732,438345,439695,2,6,1350,15,7
0227b4b6,438265,440105,6,2,1840,15,7
062e6ec1,438405,440475,1,6,2070,15,7
020168a6,539055,539465,6,2,410,15,7
015ff9e3,539645,540215,3,1,570,15,7
065f48d4,539605,540575,4,6,970,15,7
04fa8796,539785,540945,6,4,1160,15,7
01a1d2a0,539595,541305,0,1,1710,15,7
054e3c81,539795,541665,1,5,1870,15,7
04535242,1015,1515,2,4,500,2,14
0395e819,12065,12605,6,3,540,2,14
0b056638,34095,34525,2,11,430,2,14
07f998d8,34155,35315,8,7,1160,2,14
0697b0d4,34145,35675,9,6,1530,2,14
033e3014,34375,36035,10,3,1660,2,14
0cff7e52,34895,36395,11,12,1500,2,14
0adf78c4,34605,36765,13,10,2160,2,14
0628465c,34255,37125,0,6,2870,2,14
043f176c,34425,37485,1,4,3060,2,14
067cd0dd,34415,37845,2,6,3430,2,14
02457ed4,34565,38235,5,2,3670,2,14
0cde9f98,34645,38605,7,12,3960,2,14
01069f27,35215,38975,9,1,3760,2,14
0c784c54,34745,39725,13,12,4980,2,14
00dcd3d4,34525,40095,1,0,5570,2,14
022d6127,35085,40505,5,2,5420,2,14
0574a022,135005,135385,2,5,380,2,14
04fe91d9,135005,135745,9,4,740,2,14
0044923a,135005,136105,10,0,1100,2,14
0a30aca0,135005,136465,0,10,1460,2,14
028bdf2a,135005,136825,10,2,1820,2,14
0a07ae80,135005,137185,0,10,2180,2,14
048495c0,135005,137545,0,4,2540,2,14
06b582d5,135005,137905,5,6,2900,2,14
04f62634,135005,138265,4,4,3260,2,14
0db2280d,135005,138625,13,13,3620,2,14
0b845aaa,135005,138985,10,11,3980,2,14
0703e96c,135005,139345,12,7,4340,2,14
01c380d8,135005,139705,8,1,4700,2,14
0dfdd6bb,135005,140065,11,13,5060,2,14
04b34d8d,337115,337945,13,4,830,2,14
040f3783,539035,539445,3,4,410,2,14
01535245,1095,1655,5,1,560,2,12
0a95e817,12045,12485,8,10,440,2,12
0a4d6097,12115,12875,11,10,760,2,12
0a056634,23015,23405,4,10,390,2,12
0797b0d8,34035,34485,8,7,450,2,12
043e3013,34195,35255,1,4,1060,2,12
03de9f9b,34545,35615,2,3,1070,2,12
0b7cd0d2,34275,35975,3,11,1700,2,12
00f998d7,34065,36335,4,0,2270,2,12
07df78c1,34495,36695,5,7,2200,2,12
09752125,34175,37055,6,9,2880,2,12
01724c69,34625,37415,7,1,2790,2,12
00284655,34075,37775,8,0,3700,2,12
0262ad54,36085,38135,9,2,2050,2,12
02ff7e54,34825,38495,10,2,3670,2,12
09784c58,34715,38855,11,9,4140,2,12
06a4ec5b,35205,39215,0,6,4010,2,12
0a07ae85,35135,39935,2,10,4800,2,12
0074a028,36125,40295,3,0,4170,2,12
007be710,37225,41015,5,0,3790,2,12
083d2aa3,34775,41375,6,8,6600,2,12
0942120b,35715,41735,7,9,6020,2,12
00284655,34075,42095,8,0,8020,2,12
05fe91d0,36195,42455,9,5,6260,2,12
03cdb8f8,34925,43175,11,3,8250,2,12
06a4ec5b,35205,43535,0,6,8330,2,12
0a07ae85,35135,44255,2,10,9120,2,12
0074a028,36125,44615,3,0,8490,2,12
065fb4c0,135005,135385,0,6,380,2,12
099a18f2,135005,135745,2,9,740,2,12
00d945c2,135005,136465,2,0,1460,2,12
0be37890,135005,136825,0,11,1820,2,12
0433ed08,135005,137185,8,4,2180,2,12
007fc511,135005,137545,1,0,2540,2,12
0bd7f0c3,135005,137905,3,11,2900,2,12
047edc81,135005,138265,1,4,3260,2,12
0a6333a5,135005,138625,5,10,3620,2,12
02a4b154,135005,138985,4,2,3980,2,12
06c4bd98,135005,139345,8,6,4340,2,12
06cdb125,337045,337455,5,6,410,2,12
085007e0,337095,337925,0,8,830,2,12
059e7390,539115,539705,0,5,590,2,12
0a5816d1,539095,540065,1,10,970,2,12
02535240,1015,1435,0,2,420,3,3
01056632,34095,34505,0,1,410,3,3
0297b0d2,34195,34865,1,2,670,3,3
01284652,34255,35225,2,1,970,3,3
01ff7e50,34985,36305,2,1,1320,3,3
01ff7e50,34985,37385,2,1,2400,3,3
02f62632,135005,135745,2,2,740,3,3
01421202,135005,136105,2,1,1100,3,3
023b8130,438015,438425,0,2,410,3,3
01c380d0,438085,438815,0,1,730,3,3
017d6530,539105,539515,0,1,410,3,3
02535241,1035,1575,1,2,540,14,10
0695e814,12025,12505,7,6,480,14,10
0697b0d7,12155,12865,8,6,710,14,10
06056638,12115,13225,9,6,1110,14,10
064d6095,12065,13595,1,6,1530,14,10
06284652,12195,13955,2,6,1760,14,10
06f998d3,12185,14325,4,6,2140,14,10
06752126,12225,14855,4,6,2630,14,10
093e3012,23075,23605,2,9,530,14,10
06457ed2,23345,24135,2,6,790,14,10
08df78c5,34035,34445,4,8,410,14,10
08ff7e54,34165,34815,6,8,650,14,10
01de9f93,34045,35175,7,1,1130,14,10
04696ce3,34455,35535,8,4,1080,14,10
01f62632,34965,35895,9,1,930,14,10
0607ae81,34505,36255,0,6,1750,14,10
04784c50,34105,36615,1,4,2510,14,10
04272774,34185,36975,2,4,2790,14,10
02421201,35105,37335,3,2,2230,14,10
01726655,34895,37695,4,1,2800,14,10
018495c5,34665,38055,5,1,3390,14,10
07a4ec51,34565,38415,6,7,3850,14,10
063d2aa7,34145,38775,7,6,4630,14,10
03845aa3,35155,39135,8,3,3980,14,10
0362ad52,35565,39495,9,3,3930,14,10
03e618a7,36265,39855,0,3,3590,14,10
08069f28,34375,40575,2,8,6200,14,10
02fe91d8,35775,41305,5,2,5530,14,10
0050deb4,36525,41675,7,0,5150,14,10
090f3782,36375,42035,8,9,5660,14,10
05265b67,36545,42395,9,5,5850,14,10
035fb4c7,135005,135385,7,3,380,14,10
01d7f0c2,135005,135745,2,1,740,14,10
00b4b495,135005,136105,5,0,1100,14,10
0190d446,135005,136465,6,1,1460,14,10
0990b2a5,135005,136825,5,9,1820,14,10
07bc4b88,135005,137185,8,7,2180,14,10
01567860,135005,137905,0,1,2900,14,10
08921c00,135005,138265,0,8,3260,14,10
07513ae9,135005,138625,9,7,3620,14,10
067fc511,135005,138985,1,6,3980,14,10
08488789,135005,139345,9,8,4340,14,10
05292b38,135005,139705,8,5,4700,14,10
081ff440,135005,140065,0,8,5060,14,10
05e07291,135005,141145,1,5,6140,14,10
02761374,135005,141505,4,2,6500,14,10
08cee617,135005,141865,7,8,6860,14,10
07c4bd90,135005,142225,0,7,7220,14,10
08c42737,337105,337495,7,8,390,14,10
042e6ec3,337115,337945,3,4,830,14,10
080168a3,438095,438505,3,8,410,14,10
048d14e3,438195,439035,3,4,840,14,10
09bb90e2,539205,539595,2,9,390,14,10
04535241,1015,1455,1,4,440,8,6
0495e813,12065,12445,0,4,380,8,6
04f998d3,12295,12815,2,4,520,8,6
04056634,12225,13175,3,4,950,8,6
044d6091,12155,13895,5,4,1740,8,6
0497b0d4,12265,14255,0,4,1990,8,6
04284654,12355,14685,5,4,2330,8,6
017cd0d0,23085,23895,0,1,810,8,6
003f1760,34035,34485,2,0,450,8,6
01df78c4,34225,34855,4,1,630,8,6
01069f24,34785,35215,5,1,430,8,6
01dcd3d1,34085,35575,0,1,1490,8,6
02cdb8f4,34775,35935,1,2,1160,8,6
01696ce4,34795,36655,3,1,1860,8,6
022d6123,34715,37015,4,2,2300,8,6
02726650,35155,37375,5,2,2220,8,6
0403e965,35545,37735,0,4,2190,8,6
03b22803,35355,38095,1,3,2740,8,6
05f62631,35255,38455,2,5,3200,8,6
04845aa4,35445,38815,3,4,3370,8,6
00421202,35425,39185,5,0,3760,8,6
0279a0b4,135005,135385,4,2,380,8,6
0599bf15,135005,135745,5,5,740,8,6
044569f5,135005,136105,5,4,1100,8,6
05c380d5,135005,136465,5,5,1460,8,6
05449231,135005,136825,1,5,1820,8,6
040f3785,135005,137185,5,4,2180,8,6
01da9f85,135005,137905,5,1,2900,8,6
01fe91d1,135005,138625,1,1,3620,8,6
024b3413,135005,138985,3,2,3980,8,6
03502bc0,135005,139345,0,3,4340,8,6
005007e3,337145,338205,3,0,1060,8,6
039e7395,337315,338575,5,3,1260,8,6
055816d0,337245,338935,0,5,1690,8,6
00488784,438225,438655,4,0,430,8,6
00a595b5,438325,439015,5,0,690,8,6
02b4b493,438415,439425,3,2,1010,8,6
032ae3f5,438515,439795,5,3,1280,8,6
01f38863,539135,539555,3,1,420,8,6
00535241,1065,1455,1,0,390,6,2
00f998d1,34025,34425,1,0,400,6,2
00dcd3d1,34285,35145,1,0,860,6,2
013d2aa1,34665,35505,0,1,840,6,2
00724c61,34535,35865,1,0,1330,6,2
013d2aa1,34665,36225,0,1,1560,6,2
003870a0,135005,135385,0,0,380,6,2
01726651,135005,136465,1,1,1460,6,2
01c380d0,337095,337475,0,1,380,6,2
01fdd6b0,438095,438485,0,1,390,6,2
007d6531,438085,438845,1,0,760,6,2
0063eae1,539155,539575,1,0,420,6,2
01535240,1055,1445,0,1,390,3,3
004d6092,23035,23425,2,0,390,3,3
0097b0d2,23155,23815,2,0,660,3,3
01284651,34095,34845,0,1,750,3,3
003f1762,34335,35205,1,0,870,3,3
00dcd3d0,34425,35565,2,0,1140,3,3
023e3012,34235,35925,0,2,1690,3,3
02df78c2,34575,36285,1,2,1710,3,3
00dcd3d0,34425,36645,2,0,2220,3,3
023e3012,34235,37005,0,2,2770,3,3
02df78c2,34575,37365,1,2,2790,3,3
00dcd3d0,34425,37725,2,0,3300,3,3
023e3012,34235,38085,0,2,3850,3,3
02df78c2,34575,38445,1,2,3870,3,3
01e618a1,135005,135385,1,1,380,3,3
020f3782,135005,135745,2,2,740,3,3
00265b60,135005,136105,0,0,1100,3,3
02fdd2a1,337025,337435,1,2,410,3,3
027be710,337115,338155,0,2,1040,3,3
01241852,438075,438465,2,1,390,3,3
002554f2,438165,438855,2,0,690,3,3
02c603b1,539015,539445,1,2,430,3,3
05535246,1025,1435,6,5,410,7,8
0095e811,12085,12545,3,0,460,7,8
004d6092,12095,12905,4,0,810,7,8
00056635,12175,13265,5,0,1090,7,8
00f998d7,12305,13625,6,0,1320,7,8
00284657,12385,14075,4,0,1690,7,8
0097b0d4,12275,14435,5,0,2160,7,8
03752125,23085,23585,5,3,500,7,8
06dcd3d5,23345,24075,5,6,730,7,8
02457ed4,34065,34485,0,2,420,7,8
03de9f90,34215,34855,2,3,640,7,8
03df78c0,34145,35945,6,3,1800,7,8
05ff7e51,34435,36355,2,5,1920,7,8
0762ad57,135005,135385,7,7,380,7,8
0630aca2,135005,135745,2,6,740,7,8
0579a0b3,135005,136465,3,5,1460,7,8
03a4b154,135005,136825,4,3,1820,7,8
012d6127,135005,137185,7,1,2180,7,8
05e28bd3,135005,137545,3,5,2540,7,8
03845aa4,135005,137905,4,3,2900,7,8
00449237,135005,138265,7,0,3260,7,8
04502bc5,135005,138985,5,4,3980,7,8
006333a7,135005,139345,7,0,4340,7,8
03a4ec51,135005,140065,1,3,5060,7,8
03b22807,135005,140425,7,3,5420,7,8
017d6533,135005,140785,3,1,5780,7,8
014569f4,337075,337595,4,1,520,7,8
07d945c3,438085,438515,3,7,430,7,8
00bc05b4,438105,438875,4,0,770,7,8
05e32497,438245,439265,7,5,1020,7,8
05e37890,438145,439625,0,5,1480,7,8
067fc514,539265,539845,4,6,580,7,8
01d7f0c6,539405,540215,6,1,810,7,8
00535242,1035,1495,2,0,460,11,5
004d6090,12105,12485,1,0,380,11,5
003e3011,12385,12855,3,0,470,11,5
0095e810,12085,13215,4,0,1130,11,5
00056632,12195,13935,1,0,1740,11,5
00284654,12355,14325,4,0,1970,11,5
03dcd3d4,23105,23545,4,3,440,11,5
03784c54,23315,23975,4,3,660,11,5
02ff7e50,34045,34425,3,2,380,11,5
04696ce1,34145,35145,0,4,1000,11,5
00069f24,34105,35865,2,0,1760,11,5
0407ae81,34205,36225,3,4,2020,11,5
03421201,34675,36585,4,3,1910,11,5
0274a021,35135,36945,0,2,1810,11,5
04572cf0,35255,37305,1,4,2050,11,5
0130aca0,35465,37665,2,1,2200,11,5
01a12893,35855,38025,3,1,2170,11,5
023327e2,36385,38385,4,2,2000,11,5
0399bf11,36425,38745,0,3,2320,11,5
03307622,36585,39105,1,3,2520,11,5
035fb4c2,36685,39465,2,3,2780,11,5
0412f962,135005,135385,2,4,380,11,5
00bf6d31,135005,135745,1,0,740,11,5
01599fa1,135005,136105,1,1,1100,11,5
038db5a1,135005,136465,1,3,1460,11,5
029a18f3,135005,136825,3,2,1820,11,5
049e7393,135005,137185,3,4,2180,11,5
01b36cb4,135005,137905,4,1,2900,11,5
0340cd03,135005,138265,3,3,3260,11,5
03ec0d73,135005,138625,3,3,3620,11,5
02eed560,337055,337455,0,2,400,11,5
009e94e1,337095,337815,1,0,720,11,5
011340a0,337195,338225,0,1,1030,11,5
00bc4b83,438235,438655,3,0,420,11,5
00f2c044,438385,439015,4,0,630,11,5
044bf940,438245,439375,0,4,1130,11,5
017ca592,438405,439745,2,1,1340,11,5
0265d933,438295,440105,3,2,1810,11,5
03cde4d0,438505,440475,0,3,1970,11,5
01b49ca3,539245,539655,3,1,410,11,5
0595e812,12085,12505,1,5,420,10,7
05f998d5,12355,12865,2,5,510,10,7
05056634,12255,13225,3,5,970,10,7
054d6095,12185,13585,4,5,1400,10,7
0597b0d1,12325,13975,0,5,1650,10,7
00284654,23075,23565,4,0,490,10,7
00457ed4,23305,24035,4,0,730,10,7
05df78c0,34075,34565,4,5,490,10,7
03784c52,34315,35655,1,3,1340,10,7
013d2aa2,34385,36015,2,1,1630,10,7
022d6124,34565,36375,3,2,1810,10,7
01724c66,34215,36735,4,1,2520,10,7
01272773,34525,37105,6,1,2580,10,7
04ff7e51,34485,37495,2,4,3010,10,7
04069f20,34725,37855,3,4,3130,10,7
01cdb8f4,34625,38215,4,1,3590,10,7
00572cf5,135005,135385,5,0,380,10,7
01a12891,135005,135745,1,1,740,10,7
052554f2,135005,136105,2,5,1100,10,7
009a18f2,135005,136465,2,0,1460,10,7
027fc510,135005,136825,0,2,1820,10,7
05a4ec51,135005,137185,1,5,2180,10,7
04ccc9d4,135005,137545,4,4,2540,10,7
04b34d82,135005,137905,2,4,2900,10,7
007be712,135005,138265,2,0,3260,10,7
005fb4c1,135005,138625,1,0,3620,10,7
0133ed02,135005,138985,2,1,3980,10,7
015007e5,135005,139345,5,1,4340,10,7
06421203,135005,139705,3,6,4700,10,7
05488780,337055,337495,0,5,440,10,7
032ae3f2,337165,337865,2,3,700,10,7
01a595b4,337075,338235,4,1,1160,10,7
02b4b496,337125,338605,6,2,1480,10,7
04caf2a1,438085,438595,1,4,510,10,7
01563582,438155,438955,2,1,800,10,7
02ff29c0,539105,539665,0,2,560,10,7
06dbc261,539175,540025,1,6,850,10,7
0b535247,1095,1695,7,11,600,2,12
0b95e818,12075,12525,10,11,450,2,12
0b056633,34015,34425,5,11,410,2,12
08284651,34135,34795,7,8,660,2,12
043f1768,34405,35155,8,4,750,2,12
0bf998d2,34115,35515,9,11,1400,2,12
06752129,34225,36235,11,6,2010,2,12
06dcd3da,34495,36595,0,6,2100,2,12
0a457ed0,34555,36965,2,10,2410,2,12
0a97b0d3,34095,37325,3,10,3230,2,12
007cd0d9,34375,37695,5,0,3320,2,12
093e3018,34275,38065,7,9,3790,2,12
01de9f92,34715,38455,10,1,3740,2,12
03784c55,34895,38815,11,3,3920,2,12
007cd0d9,34375,39265,5,0,4890,2,12
02a4ec5b,135005,135385,11,2,380,2,12
06e28bd0,135005,135745,0,6,740,2,12
083870a6,135005,136465,6,8,1460,2,12
00421202,135005,136825,2,0,1820,2,12
06ccc9d7,135005,137185,7,6,2180,2,12
063b813b,135005,137545,11,6,2540,2,12
047d6536,135005,137905,6,4,2900,2,12
0662ad5a,135005,138265,10,6,3260,2,12
02272778,135005,138625,8,2,3620,2,12
08cdb8f2,135005,138985,2,8,3980,2,12
06696ce2,135005,139345,2,6,4340,2,12
0663eae8,337095,337515,8,6,420,2,12
00fe91d8,438035,438885,8,0,850,2,12
03535248,1055,1475,8,3,420,13,16
024d609a,12115,12495,8,2,380,13,16
0295e819,12085,13415,5,2,1330,13,16
0297b0da,12175,13775,6,2,1600,13,16
0ff998da,23075,23525,10,15,450,13,16
063f176a,23385,24175,10,6,790,13,16
01dcd3d6,34015,34425,5,1,410,13,16
09457eda,34035,34785,6,9,750,13,16
0bdf78cb,34075,35145,7,11,1070,13,16
02de9f97,34145,35515,9,2,1370,13,16
02a4ec54,34645,35875,10,2,1230,13,16
06724c63,34225,36235,11,6,2010,13,16
0f069f2a,34565,36595,12,15,2030,13,16
0242120c,34845,36955,13,2,2110,13,16
09784c5b,34235,37315,14,9,3080,13,16
0007ae8b,34635,37675,15,0,3040,13,16
0ffdd6b5,35255,38035,0,15,2780,13,16
0eb22809,34835,38395,1,14,3560,13,16
042d6122,34515,38755,2,4,4240,13,16
04e28bdc,34685,39115,3,4,4430,13,16
08ff7e54,34385,39475,4,8,5090,13,16
0d3d2aaa,34305,39835,5,13,5530,13,16
04696ce8,34605,40205,7,4,5600,13,16
03b582d4,34725,40575,9,3,5850,13,16
04f62632,34765,40935,10,4,6170,13,16
06c380dd,35195,41295,11,6,6100,13,16
0bccc9de,35025,41655,12,11,6630,13,16
033b813d,35165,42015,13,3,6850,13,16
0b74a029,35365,42405,0,11,7040,13,16
0b63eae1,35435,42765,1,11,7330,13,16
06845aae,34935,43135,3,6,8200,13,16
0c03e96d,35125,43505,5,12,8380,13,16
06ec0d78,135005,135385,8,6,380,13,16
02bf6d3d,135005,135745,13,2,740,13,16
09617731,135005,136105,1,9,1100,13,16
09fb6653,135005,136465,3,9,1460,13,16
0beed566,135005,136825,6,11,1820,13,16
065c4700,135005,137905,0,6,2900,13,16
0f9837d6,135005,138265,6,15,3260,13,16
09396507,135005,138625,7,9,3620,13,16
00f41134,135005,139345,4,0,4340,13,16
01521324,135005,139705,4,1,4700,13,16
02572cff,135005,140065,15,2,5060,13,16
0bbf9c61,135005,140425,1,11,5420,13,16
0dc4bd9d,135005,140785,13,13,5780,13,16
0e9e739c,135005,141145,12,14,6140,13,16
08599fa3,135005,141505,3,8,6500,13,16
022e2ed2,135005,141865,2,2,6860,13,16
0ef72fdc,135005,142225,12,14,7220,13,16
007ca59c,135005,142585,12,0,7580,13,16
0cebab46,135005,142945,6,12,7940,13,16
0f7c63dc,135005,143305,12,15,8300,13,16
0759f268,135005,143665,8,7,8660,13,16
0c578a1b,135005,144025,11,12,9020,13,16
018d14ea,135005,144385,10,1,9380,13,16
0a4e3c8c,135005,144745,12,10,9740,13,16
04df5fa2,135005,145105,2,4,10100,13,16
0d50deb3,135005,145825,3,13,10820,13,16
0fa4b152,135005,146185,2,15,11180,13,16
0be32498,135005,146545,8,11,11540,13,16
0f8568fc,337045,337595,12,15,550,13,16
09fb4aed,337245,337955,13,9,710,13,16
00dbf6be,337085,338315,14,0,1230,13,16
0b5e788f,337165,338675,15,11,1510,13,16
054df280,337435,339035,0,5,1600,13,16
01148752,337035,339405,2,1,2370,13,16
0b4e02d3,337515,339765,3,11,2250,13,16
0ae45928,337425,340195,8,10,2770,13,16
0975f4ba,337575,340565,10,9,2990,13,16
083819bb,337335,340925,11,8,3590,13,16
08cf61ec,337695,341285,12,8,3590,13,16
019b0c2f,337675,341675,15,1,4000,13,16
003050d8,337705,342185,8,0,4480,13,16
04e1bd15,438175,438645,5,4,470,13,16
0efe9537,438485,439015,7,14,530,13,16
0e02441c,438275,439445,12,14,1170,13,16
0761c86d,438195,439805,13,7,1610,13,16
0af643b4,438355,440275,4,10,1920,13,16
024f9d8d,438415,440785,13,2,2370,13,16
023e2044,539305,539945,4,2,640,13,16
07344b85,539515,540305,5,7,790,13,16
02535241,1065,1455,1,2,390,16,3
0295e810,12095,12505,0,2,410,16,3
02f998d2,12265,12865,1,2,600,16,3
027cd0d2,12465,13585,0,2,1120,16,3
023f1760,23105,23505,0,2,400,16,3
02457ed0,23165,23895,0,2,730,16,3
00df78c0,34075,34485,2,0,410,16,3
013d2aa1,34295,34845,0,1,550,16,3
00784c51,34235,35205,1,0,970,16,3
00724c60,34175,35565,2,0,1390,16,3
02cdb8f1,34505,35925,0,2,1420,16,3
0130aca0,35895,37005,0,1,1110,16,3
0014c3c0,35955,37365,1,0,1410,16,3
026333a2,36945,38085,0,2,1140,16,3
0014c3c0,35955,38445,1,0,2490,16,3
021559f1,135005,135385,1,2,380,16,3
0025a772,135005,135745,2,0,740,16,3
00a0c8e1,135005,136105,1,0,1100,16,3
01ccec22,135005,136465,2,1,1460,16,3
01119790,337075,337475,0,1,400,16,3
0090b2a2,337165,337845,2,0,680,16,3
026adab0,337255,338205,0,2,950,16,3
011340a2,438455,438825,2,1,370,16,3
00f2c042,438695,439905,2,0,1210,16,3
0265d930,438665,440265,0,2,1600,16,3
00187791,438555,440625,1,0,2070,16,3
02807690,539725,540545,0,2,820,16,3
02261f71,539625,540905,1,2,1280,16,3
02535243,1065,1455,3,2,390,2,4
0295e813,12095,12505,1,2,410,2,4
034d6091,23105,23505,1,3,400,2,4
00056630,34075,34465,3,0,390,2,4
01752121,34335,34825,0,1,490,2,4
027cd0d1,34455,35185,1,2,730,2,4
03f998d3,34245,35545,2,3,1300,2,4
0297b0d1,34175,35905,3,2,1730,2,4
00724c61,34715,36625,1,0,1910,2,4
033e3011,34355,36985,2,3,2630,2,4
0297b0d1,34175,37345,3,2,3170,2,4
00724c61,34715,38065,1,0,3350,2,4
033e3011,34355,38425,2,3,4070,2,4
0074a020,135005,135385,0,0,380,2,4
0103e963,135005,135745,3,1,740,2,4
00c380d2,135005,136105,2,0,1100,2,4
03fdd6b1,135005,136465,1,3,1460,2,4
00572cf1,337075,337455,1,0,380,2,4
019650a3,438125,438515,3,1,390,2,4
01449230,438095,438875,0,1,780,2,4
0014c3c3,539135,539555,3,0,420,2,4
06535244,1025,1435,4,6,410,3,10
0795e819,12025,12425,3,7,400,3,10
094d6096,23015,23485,6,9,470,3,10
05056635,34015,34505,7,5,490,3,10
05752125,34195,35235,0,5,1040,3,10
067cd0d3,34295,35595,1,6,1300,3,10
092d6127,35065,35955,2,9,890,3,10
068495c5,35315,36315,3,6,1000,3,10
05284657,34155,36675,4,5,2520,3,10
02784c50,34785,37035,5,2,2250,3,10
08a4ec52,35285,37395,6,8,2110,3,10
083e3010,34205,37755,7,8,3550,3,10
00ff7e58,34955,38115,8,0,3160,3,10
07421202,35595,38475,9,7,2880,3,10
033870a7,35495,39195,1,3,3700,3,10
04c380d8,35815,39555,2,4,3740,3,10
06ccc9d5,35695,39915,3,6,4220,3,10
053d2aa2,34855,40275,4,5,5420,3,10
09f62636,35465,40635,5,9,5170,3,10
05b22802,35515,40995,6,5,5480,3,10
083e3010,34205,41355,7,8,7150,3,10
073b8130,35775,41715,8,7,5940,3,10
02a12890,36915,42075,9,2,5160,3,10
033870a7,35495,42795,1,3,7300,3,10
079650a9,36345,43155,2,7,6810,3,10
01265b69,37025,43515,3,1,6490,3,10
053d2aa2,34855,43875,4,5,9020,3,10
063327e1,135005,135385,1,6,380,3,10
01c4bd97,135005,135745,7,1,740,3,10
001559f5,135005,136105,5,0,1100,3,10
02d60b76,135005,136465,6,2,1460,3,10
09bc05b5,135005,136825,5,9,1820,3,10
0333ed03,135005,137185,3,3,2180,3,10
0512f968,135005,137545,8,5,2540,3,10
057edc86,135005,137905,6,5,2900,3,10
00cdb121,135005,138265,1,0,3260,3,10
082554f2,135005,138625,2,8,3620,3,10
06bf6d39,337115,337535,9,6,420,3,10
0928f1f1,337055,337905,1,9,850,3,10
0592f858,438075,438585,8,5,510,3,10
04488782,438175,438995,2,4,820,3,10
0195e811,12035,12425,2,1,390,10,3
024d6090,23105,23505,0,2,400,10,3
017cd0d0,23545,24285,0,1,740,10,3
013f1761,34055,34435,2,1,380,10,3
01dcd3d1,34145,34795,0,1,650,10,3
02de9f90,34275,35155,1,2,880,10,3
01724c62,34355,35515,2,1,1160,10,3
01cdb8f0,34805,35875,0,1,1070,10,3
00784c52,34405,36235,1,0,1830,10,3
01726651,35265,36595,2,1,1330,10,3
00449231,36205,37315,1,0,1110,10,3
01726651,35265,37675,2,1,2410,10,3
0030aca1,36295,38395,1,0,2100,10,3
00241852,135005,135745,2,0,740,10,3
001559f2,135005,136105,2,0,1100,10,3
0279a0b2,135005,136465,2,2,1460,10,3
02307621,135005,136825,1,2,1820,10,3
01e32491,135005,137185,1,1,2180,10,3
025007e1,337025,337435,1,2,410,10,3
0128f1f2,337205,338875,2,1,1670,10,3
022ae3f0,438165,438575,0,2,410,10,3
01563580,438245,439655,0,1,1410,10,3
02f38861,438315,440015,1,2,1700,10,3
018565f2,539525,540025,2,1,500,10,3
029a82f0,539375,540385,0,2,1010,10,3
028fdf71,539635,540745,1,2,1110,10,3
01535243,1015,1455,3,1,440,14,4
0095e813,12015,12395,3,0,380,14,4
0097b0d1,23095,23505,1,0,410,14,4
00dcd3d1,23465,23915,1,0,450,14,4
03df78c0,34035,34415,0,3,380,14,4
00de9f92,34125,34775,1,0,650,14,4
00784c53,34235,35495,3,0,1260,14,4
02696ce1,34615,36215,1,2,1600,14,4
01fdd6b3,35505,36935,3,1,1430,14,4
01449232,35825,37295,0,1,1470,14,4
009650a0,35885,38375,3,0,2490,14,4
030f3783,135005,135745,3,3,740,14,4
03c603b3,135005,137185,3,3,2180,14,4
02bc05b3,135005,137545,3,2,2540,14,4
035816d0,135005,137905,0,3,2900,14,4
02b36cb1,337045,337455,1,2,410,14,4
028db5a1,337095,337865,1,2,770,14,4
0036cda1,438135,439265,1,0,1130,14,4
03fb6652,438205,439625,2,3,1420,14,4
00fcf0e2,539305,539695,2,0,390,14,4
00535241,1065,1455,1,0,390,12,2
0095e811,12025,12425,1,0,400,12,2
00f998d1,12365,13145,1,0,780,12,2
00752121,12515,13865,1,0,1350,12,2
017cd0d0,23055,23445,0,1,390,12,2
01724c60,23435,23825,0,1,390,12,2
00cdb8f0,34045,34425,1,0,380,12,2
01696ce0,34115,34785,0,1,670,12,2
01b22801,34595,35505,0,1,910,12,2
01bc05b0,135005,135745,0,1,740,12,2
00599fa1,337095,337795,1,0,700,12,2
01bb4a30,337235,338155,0,1,920,12,2
00292b31,337335,338515,1,0,1180,12,2
04535240,1045,1435,0,4,390,15,6
0095e810,12055,12435,5,0,380,15,6
00056631,12175,13155,1,0,980,15,6
00f998d0,12255,13515,2,0,1260,15,6
0097b0d2,12245,13875,3,0,1630,15,6
004d6091,12085,14235,4,0,2150,15,6
003e3015,12385,14595,5,0,2210,15,6
00457ed4,12485,15315,1,0,2830,15,6
00752122,12315,15675,2,0,3360,15,6
00df78c0,12555,16035,3,0,3480,15,6
00de9f91,12615,16395,4,0,3780,15,6
01a4ec54,23465,23975,4,1,510,15,6
02f62634,23765,24425,4,2,660,15,6
043870a2,34055,34465,1,4,410,15,6
013b8133,34345,34825,2,1,480,15,6
04ccc9d5,34245,35185,3,4,940,15,6
03845aa4,34185,35545,4,3,1360,15,6
00421203,34125,35905,5,0,1780,15,6
05572cf1,34705,36265,0,5,1560,15,6
0562ad54,34585,36625,1,5,2040,15,6
0174a025,34595,37345,3,1,2750,15,6
01cdb121,135005,135385,1,1,380,15,6
02ff29c3,135005,135745,3,2,740,15,6
0579a0b4,135005,136825,4,5,1820,15,6
05d60b75,135005,137185,5,5,2180,15,6
02f38862,135005,137545,2,2,2540,15,6
02fc1295,135005,137905,5,2,2900,15,6
03102c32,135005,138265,2,3,3260,15,6
04502bc5,135005,138625,5,4,3620,15,6
039a18f3,135005,138985,3,3,3980,15,6
0025a774,135005,139345,4,0,4340,15,6
059e94e2,337105,337515,2,5,410,15,6
04e8a385,337365,338245,5,4,880,15,6
041340a1,337255,338965,1,4,1710,15,6
04cde4d2,438315,438715,2,4,400,15,6
02b49ca3,438555,439075,3,2,520,15,6
000b7d94,438405,439435,4,0,1030,15,6
03371950,438695,440155,0,3,1460,15,6
034266d1,438435,440515,1,3,2080,15,6
035e2762,438465,440875,2,3,2410,15,6
0071a464,438795,441245,4,0,2450,15,6
0072db61,438645,441635,1,0,2990,15,6
0449b045,539025,539425,5,4,400,15,6
05ebab42,539215,540115,2,5,900,15,6
04530c73,539405,540475,3,4,1070,15,6
00e07295,539625,541195,5,0,1570,15,6
02567860,539725,541555,0,2,1830,15,6
02535246,1035,1555,6,2,520,2,9
0595e813,12055,12465,1,5,410,2,9
054d6096,12145,12825,2,5,680,2,9
04056635,23035,23545,5,4,510,2,9
01f998d0,34165,34545,5,1,380,2,9
0097b0d5,34105,34905,6,0,800,2,9
00752123,34295,35265,7,0,970,2,9
067cd0d2,34355,35625,8,6,1270,2,9
02284657,34195,35985,0,2,1790,2,9
04457ed0,34555,36345,1,4,1790,2,9
05cdb8f0,35035,36705,2,5,1670,2,9
08784c55,34785,37065,3,8,2280,2,9
02df78c1,34595,37425,4,2,2830,2,9
02de9f98,34675,37785,5,2,3110,2,9
033e3016,34335,38155,7,3,3820,2,9
033f1767,34405,38515,8,3,4110,2,9
013d2aa1,34845,39285,4,1,4440,2,9
02de9f98,34675,39645,5,2,4970,2,9
05c380d7,135005,135385,7,5,380,2,9
06fdd6b4,135005,135745,4,6,740,2,9
078495c5,135005,136465,5,7,1460,2,9
04b582d2,135005,136825,2,4,1820,2,9
06f62636,135005,137185,6,6,2180,2,9
08b22803,135005,137545,3,8,2540,2,9
06845aa1,135005,137905,1,6,2900,2,9
0603e967,135005,138265,7,6,3260,2,9
03fe91d8,337065,337515,8,3,450,2,9
01572cf8,337135,338025,8,1,890,2,9
03449238,539035,539545,8,3,510,2,9
024d6091,12165,12885,3,2,720,13,7
0297b0d2,12255,13245,4,2,990,13,7
02056636,12245,13615,6,2,1370,13,7
05f998d0,23065,23485,0,5,420,13,7
01752120,23125,23955,0,1,830,13,7
027cd0d2,34135,34565,4,2,430,13,7
043e3010,34085,34925,5,4,840,13,7
03dcd3d6,34205,35285,6,3,1080,13,7
00de9f93,34435,35655,1,0,1220,13,7
06784c55,34485,36015,2,6,1530,13,7
04457ed5,34275,36375,3,4,2100,13,7
01ff7e50,34595,36735,4,1,2140,13,7
003f1763,34145,37095,5,0,2950,13,7
04e28bd4,35135,37455,6,4,2320,13,7
02b22803,35485,37815,0,2,2330,13,7
03c380d3,35635,38535,2,3,2900,13,7
06449234,36045,38895,3,6,2850,13,7
01513ae1,36665,39255,4,1,2590,13,7
02e618a5,36295,39615,5,2,3320,13,7
0279a0b5,36835,39975,6,2,3140,13,7
0250deb6,36475,40335,0,2,3860,13,7
05fdd2a2,36735,41065,3,5,4330,13,7
01241854,36955,41425,4,1,4470,13,7
06f38865,135005,135745,5,6,740,13,7
06fcf0e3,135005,136465,3,6,1460,13,7
014bf942,135005,136825,2,1,1820,13,7
05c603b0,135005,137185,0,5,2180,13,7
00d945c3,135005,137545,3,0,2540,13,7
04caf2a5,135005,137905,5,4,2900,13,7
018fdf71,135005,138265,1,1,3260,13,7
0090b2a2,135005,138625,2,0,3620,13,7
04187790,135005,138985,0,4,3980,13,7
05371953,135005,139345,3,5,4340,13,7
04d60b76,135005,139705,6,4,4700,13,7
0225a774,135005,140065,4,2,5060,13,7
0549b042,337055,337535,2,5,480,13,7
04261f73,337135,337895,3,4,760,13,7
04807695,337155,338265,5,4,1110,13,7
01530c73,438295,438705,3,1,410,13,7
017e4086,438455,439095,6,1,640,13,7
047a6fd3,438585,439845,3,4,1260,13,7
031451c6,438535,440235,6,3,1700,13,7
06ea7660,539345,539835,0,6,490,13,7
02535240,1015,1475,0,2,460,8,7
0395e813,12065,12505,1,3,440,8,7
03056634,12205,13235,4,3,1030,8,7
0497b0d3,23025,23405,3,4,380,8,7
02f998d3,34095,34485,0,2,390,8,7
04df78c6,34605,35215,3,4,610,8,7
032d6122,35055,35575,4,3,520,8,7
03284655,34195,35935,5,3,1740,8,7
04cdb8f1,35065,36295,6,4,1230,8,7
063f1765,34405,36655,0,6,2250,8,7
03724c63,34725,37015,1,3,2290,8,7
00069f24,35115,37735,3,0,2620,8,7
05726652,35435,38095,4,5,2660,8,7
063b8130,35835,38455,5,6,2620,8,7
05fdd6b2,36055,38815,6,5,2760,8,7
0462ad53,36065,39175,0,4,3110,8,7
054b3410,36775,39895,2,5,3120,8,7
060f3780,36925,40255,3,6,3330,8,7
00bf9c61,37155,40615,4,0,3460,8,7
063b8130,35835,40975,5,6,5140,8,7
03265b60,37055,41335,6,3,4280,8,7
00241852,37545,41705,1,0,4160,8,7
04ec0d76,135005,135385,6,4,380,8,7
04cdb126,135005,135745,6,4,740,8,7
01a595b1,135005,136105,1,1,1100,8,7
00599fa3,135005,136465,3,0,1460,8,7
028fdf73,135005,136825,3,2,1820,8,7
033327e6,135005,137185,6,3,2180,8,7
03da9f83,135005,137545,3,3,2540,8,7
0692f853,135005,138265,3,6,3260,8,7
01a0c8e0,135005,138625,0,1,3620,8,7
008565f0,135005,138985,0,0,3980,8,7
031559f6,135005,139705,6,3,4700,8,7
03e94df0,337125,337505,0,3,380,8,7
04ae2b52,337045,337875,2,4,830,8,7
0490b2a2,438255,438645,2,4,390,8,7
016adab3,438345,439005,3,1,660,8,7
03ebc9a5,438555,439375,5,3,820,8,7
00daddc6,438495,439735,6,0,1240,8,7
02fcf0e0,438415,440095,0,2,1680,8,7
03976676,539225,539695,6,3,470,8,7
01535246,1035,1475,6,1,440,7,10
0595e815,12045,12525,8,5,480,7,10
054d6098,12125,12885,9,5,760,7,10
05056633,12205,13255,1,5,1050,7,10
05284657,12355,14025,6,5,1670,7,10
0597b0d7,12305,14395,8,5,2090,7,10
083e3019,23055,23545,9,8,490,7,10
087cd0d9,23155,24075,9,8,920,7,10
07dcd3d6,34155,34545,9,7,390,7,10
06724c63,34465,34915,1,6,450,7,10
03cdb8f6,34735,35275,2,3,540,7,10
003f1761,34075,35635,3,0,1560,7,10
02df78c9,34295,35995,4,2,1700,7,10
01726651,35235,36365,6,1,1130,7,10
053870a5,35345,36725,7,5,1380,7,10
02e28bd2,35115,37085,8,2,1970,7,10
06696ce0,34845,37445,9,6,2600,7,10
023d2aa8,34535,37805,0,2,3270,7,10
0007ae82,34865,38165,1,0,3300,7,10
088495c3,35015,38525,2,8,3510,7,10
00f62639,35275,38885,3,0,3610,7,10
0703e965,35665,39245,4,7,3580,7,10
0950deb3,36765,39605,5,9,2840,7,10
030f3781,36725,39965,6,3,3240,7,10
05502bc8,36995,40685,8,5,3690,7,10
04bf9c64,36875,41045,9,4,4170,7,10
0462ad53,36015,41405,0,4,5390,7,10
06449238,36325,41765,1,6,5440,7,10
07c603b1,37305,42125,2,7,4820,7,10
0814c3c7,36445,42485,3,8,6040,7,10
026333a2,37365,42845,4,2,5480,7,10
03241858,37195,43205,5,3,6010,7,10
05fdd2a9,37005,43565,6,5,6560,7,10
06265b65,36815,43925,7,6,7110,7,10
00da9f85,135005,135385,5,0,380,7,10
0133ed08,135005,135745,8,1,740,7,10
0925a776,135005,136105,6,9,1100,7,10
03bf6d37,135005,136465,7,3,1460,7,10
08563581,135005,136825,1,8,1820,7,10
00bb4a30,135005,137185,0,0,2180,7,10
06e94df1,135005,137905,1,6,2900,7,10
08daddc7,135005,138265,7,8,3260,7,10
06a4b155,135005,138625,5,6,3620,7,10
00e37892,135005,138985,2,0,3980,7,10
08ccec22,135005,139345,2,8,4340,7,10
079e7391,135005,139705,1,7,4700,7,10
082ae3f7,135005,140065,7,8,5060,7,10
00dbc266,135005,140425,6,0,5420,7,10
028fdf78,135005,140785,8,2,5780,7,10
04fb6659,135005,141145,9,4,6140,7,10
056adab2,135005,141505,2,5,6500,7,10
089e94e7,135005,141865,7,8,6860,7,10
03f2c040,337145,337555,0,3,410,7,10
09cde4d2,337295,337925,2,9,630,7,10
0865d933,337075,338285,3,8,1210,7,10
07b69db8,337265,338715,8,7,1450,7,10
047ca593,337225,339145,3,4,1920,7,10
000b7d95,438095,438545,5,0,450,7,10
014266d2,438185,439015,2,1,830,7,10
0849b043,539355,539785,3,8,430,7,10
06261f75,539375,540155,5,6,780,7,10
0671a460,539315,540585,0,6,1270,7,10
03535244,1075,1535,4,3,460,1,5
0495e812,12085,12525,3,4,440,1,5
034d6092,23025,23405,2,3,380,1,5
0097b0d1,135005,135385,1,0,380,1,5
02284653,135005,136105,3,2,1100,1,5
03752122,135005,136465,2,3,1460,1,5
02056633,135005,136825,3,2,1820,1,5
027cd0d0,337045,337455,0,2,410,1,5
0353524c,1075,1495,12,3,420,2,15
074d6090,23055,23565,0,7,510,2,15
01056630,23125,24195,0,1,1070,2,15
0397b0dc,34105,34525,13,3,420,2,15
0cf998da,34145,34885,14,12,740,2,15
0e75212a,34275,35255,1,14,980,2,15
03df78c5,34685,35615,2,3,930,2,15
06b582db,35505,35975,3,6,470,2,15
097cd0d4,34395,36335,4,9,1940,2,15
0e724c6e,34795,36695,5,14,1900,2,15
04cdb8f7,35235,37055,6,4,1820,2,15
03284654,34235,37415,7,3,3180,2,15
04dcd3d3,34565,37775,8,4,3210,2,15
0a3f176a,34485,38135,9,10,3650,2,15
0e457ed4,34585,38855,11,14,4270,2,15
097d6536,36095,39215,12,9,3120,2,15
01fe91d0,36385,39575,13,1,3190,2,15
0b62ad5b,36215,39935,14,11,3720,2,15
0403e96e,35935,40295,0,4,4360,2,15
043e301c,34335,40655,1,4,6320,2,15
0aff7e5b,35055,41015,2,10,5960,2,15
0c4b3411,36925,41375,3,12,4450,2,15
03c380de,36075,41735,4,3,5660,2,15
08784c57,34875,42095,5,8,7220,2,15
08ccc9d3,35895,42455,6,8,6560,2,15
0ae28bd2,35485,42815,7,10,7330,2,15
0774a025,36265,43175,8,7,6910,2,15
04069f22,35305,43535,9,4,8230,2,15
08726654,35545,43895,10,8,8350,2,15
09845aab,35805,44255,11,9,8450,2,15
0e63eae5,36325,44615,12,14,8290,2,15
0b62ad5b,36215,44985,14,11,8770,2,15
043e301c,34335,45355,1,4,11020,2,15
0c99bf18,135005,135745,8,12,740,2,15
0b30762c,135005,136105,12,11,1100,2,15
0c1559f2,135005,136465,2,12,1460,2,15
04da9f8b,135005,136825,11,4,1820,2,15
0c4569fc,135005,137185,12,12,2180,2,15
03bc05bd,135005,137545,13,3,2540,2,15
05e32490,135005,137905,0,5,2900,2,15
07ec0d79,135005,138265,9,7,3260,2,15
0750debb,135005,138625,11,7,3620,2,15
0cbf9c63,135005,138985,3,12,3980,2,15
0a502bc2,135005,139345,2,10,4340,2,15
0e79a0bd,135005,139705,13,14,4700,2,15
03241852,135005,140065,2,3,5060,2,15
01c603ba,135005,140425,10,1,5420,2,15
0c12f964,337095,337735,4,12,640,2,15
0eccec24,539155,539585,4,14,430,2,15
03535241,1075,1495,1,3,420,2,7
0495e812,12055,12465,6,4,410,2,7
04056636,23065,23465,6,4,400,2,7
02284656,34075,34465,6,2,390,2,7
02f998d0,34065,34825,0,2,760,2,7
02457ed2,34465,35185,1,2,720,2,7
0197b0d2,34055,35545,2,1,1490,2,7
013f1766,34285,35905,3,1,1620,2,7
057cd0d4,34255,36265,4,5,2010,2,7
033e3015,34245,36625,5,3,2380,2,7
05752124,34165,36985,6,5,2820,2,7
033d2aa2,34825,37345,0,3,2520,2,7
00df78c5,34565,37705,1,0,3140,2,7
01784c50,34735,38065,2,1,3330,2,7
01e28bd5,35315,38425,3,1,3110,2,7
02dcd3d4,34375,38785,4,2,4410,2,7
03ff7e54,34875,39145,5,3,4270,2,7
05752124,34165,39505,6,5,5340,2,7
033d2aa2,34825,39865,0,3,5040,2,7
00df78c5,34565,40225,1,0,5660,2,7
01784c50,34735,40585,2,1,5850,2,7
01e28bd5,35315,40945,3,1,5630,2,7
02dcd3d4,34375,41305,4,2,6930,2,7
03ff7e54,34875,41665,5,3,6790,2,7
05752124,34165,42025,6,5,7860,2,7
033d2aa2,34825,42385,0,3,7560,2,7
01307625,135005,135385,5,1,380,2,7
001559f3,135005,135745,3,0,740,2,7
03da9f81,135005,136105,1,3,1100,2,7
034569f4,135005,136465,4,3,1460,2,7
04bc05b6,135005,136825,6,4,1820,2,7
033327e5,135005,137185,5,3,2180,2,7
0299bf11,135005,137545,1,2,2540,2,7
0233ed03,337105,337555,3,2,450,2,7
02ec0d76,539015,539485,6,2,470,2,7
04535247,1065,1455,7,4,390,2,16
0a95e818,12035,12645,0,10,610,2,16
0d4d6099,23105,23505,9,13,400,2,16
0e056639,23155,24155,9,14,1000,2,16
0c97b0d0,34055,34505,9,12,450,2,16
093f176c,34475,34865,10,9,390,2,16
047cd0d6,34455,35235,12,4,780,2,16
07ff7e5d,34755,35595,13,7,840,2,16
02dcd3d4,34495,36315,15,2,1820,2,16
0e421203,35695,36675,0,14,980,2,16
04284656,34235,37065,3,4,2830,2,16
06069f2e,34915,37425,4,6,2510,2,16
06f998dc,34155,37785,5,6,3630,2,16
08f62633,35545,38145,6,8,2600,2,16
04df78c5,34605,38505,7,4,3900,2,16
09b582d5,35405,38865,8,9,3460,2,16
023e301b,34375,39225,9,2,4850,2,16
0207ae81,35065,39595,11,2,4530,2,16
01b22809,35645,39955,12,1,4310,2,16
018495c8,35245,40315,13,1,5070,2,16
08457ed8,34565,40685,15,8,6120,2,16
06724c66,34625,41095,3,6,6470,2,16
09de9f9a,34615,41465,5,9,6850,2,16
023e301b,34375,41875,9,2,7500,2,16
09a4ec57,35155,42245,11,9,7090,2,16
0862ad5d,135005,135385,13,8,380,2,16
0263eaef,135005,135745,15,2,740,2,16
09572cfc,135005,136105,12,9,1100,2,16
0b9650ad,135005,136465,13,11,1460,2,16
0f14c3ce,135005,136825,14,15,1820,2,16
07e618aa,135005,137185,10,7,2180,2,16
0cb34d86,135005,137545,6,12,2540,2,16
04265b6a,135005,138265,10,4,3260,2,16
05513ae4,135005,138625,4,5,3620,2,16
02fdd2af,135005,138985,15,2,3980,2,16
067be715,135005,139345,5,6,4340,2,16
022554ff,135005,139705,15,2,4700,2,16
06ccc9d6,135005,140065,6,6,5060,2,16
0e3b813a,135005,140425,10,14,5420,2,16
097d653e,135005,140785,14,9,5780,2,16
0d6333ab,337015,337575,11,13,560,2,16
0d3327ef,337065,337985,15,13,920,2,16
0999bf14,438115,438505,4,9,390,2,16
08a4b15d,438075,439015,13,8,940,2,16
0730762f,539125,539775,15,7,650,2,16
03535247,1085,1615,7,3,530,4,8
0295e810,12085,12605,6,2,520,4,8
024d6097,12145,12995,1,2,850,4,8
02056634,12195,13365,3,2,1170,4,8
0297b0d7,12235,13755,6,2,1520,4,8
00f998d3,23085,23545,3,0,460,4,8
01752123,23185,24035,3,1,850,4,8
053e3017,34035,34505,1,5,470,4,8
01457ed1,34205,34865,2,1,660,4,8
043f1763,34135,35225,3,4,1090,4,8
06de9f95,34295,35585,4,6,1290,4,8
07dcd3d5,34165,35945,5,7,1780,4,8
043d2aa1,34525,36305,6,4,1780,4,8
00df78c0,34265,36665,7,0,2400,4,8
03724c62,34345,37025,0,3,2680,4,8
037cd0d4,34105,37385,1,3,3280,4,8
05069f20,34825,37745,2,5,2920,4,8
05a4ec56,34975,38105,3,5,3130,4,8
05cdb8f3,34735,38465,4,5,3730,4,8
0262ad52,35835,38825,5,2,2990,4,8
01449230,36245,39185,6,1,2940,4,8
0250deb7,36745,39905,0,2,3160,4,8
02845aa0,35495,40265,1,2,4770,4,8
07726656,35155,40625,2,7,5470,4,8
05a4ec56,34975,40985,3,5,6010,4,8
05cdb8f3,34735,41345,4,5,6610,4,8
01b34d80,36665,41705,5,1,5040,4,8
01449230,36245,42065,6,1,5820,4,8
05da9f82,135005,135385,2,5,380,4,8
02bc05b4,135005,135745,4,2,740,4,8
01ec0d73,135005,136105,3,1,1100,4,8
04ccec27,135005,136465,7,4,1460,4,8
01cdb121,135005,136825,1,1,1820,4,8
06241850,135005,137185,0,6,2180,4,8
01307622,135005,137905,2,1,2900,4,8
0792f850,337045,338185,0,7,1140,4,8
06488780,337125,338675,0,6,1550,4,8
012ae3f2,539145,539545,2,1,400,4,8
08535240,1035,1555,0,8,520,15,15
0c95e81b,12035,12425,8,12,390,15,15
0c752127,12405,12785,9,12,380,15,15
0c056638,12175,13145,10,12,970,15,15
0cf998dd,12275,13535,13,12,1260,15,15
0c97b0d9,12265,13895,14,12,1630,15,15
0c3f1764,12575,14255,0,12,1680,15,15
0c28465d,12305,14625,2,12,2320,15,15
0c4d6095,12135,15055,7,12,2920,15,15
0c3e3017,12455,15585,2,12,3130,15,15
0c7cd0da,12535,16015,7,12,3480,15,15
01dcd3d4,23085,23645,4,1,560,15,15
0e563585,135005,135385,5,14,380,15,15
0e8db5aa,135005,135745,10,14,740,15,15
04f72fd4,135005,136105,4,4,1100,15,15
05cde4d9,135005,136465,9,5,1460,15,15
0b530c7e,135005,136825,14,11,1820,15,15
043b6cf8,135005,137545,8,4,2540,15,15
0cc4273d,135005,137905,13,12,2900,15,15
05fa8793,135005,138265,3,5,3260,15,15
06de9f9c,135005,138625,12,6,3620,15,15
08726659,135005,138985,9,8,3980,15,15
0efe91d3,135005,139345,3,14,4340,15,15
05513ae0,135005,139705,0,5,4700,15,15
0d1559fe,135005,140065,14,13,5060,15,15
0c7edc83,135005,140425,3,12,5420,15,15
07b36cb7,135005,140785,7,7,5780,15,15
0adaddce,135005,141145,14,10,6140,15,15
017ca598,135005,141505,8,1,6500,15,15
06cd928b,135005,141865,11,6,6860,15,15
0ca9b7e5,135005,142585,5,12,7580,15,15
0a1b4985,135005,142945,5,10,7940,15,15
025ff9eb,135005,143305,11,2,8300,15,15
06390860,135005,143665,0,6,8660,15,15
09e28bde,135005,144025,14,9,9020,15,15
0474a023,135005,144385,3,4,9380,15,15
0b265b62,135005,144745,2,11,9740,15,15
08307621,135005,145105,1,8,10100,15,15
07d7f0c5,135005,145465,5,7,10460,15,15
0a2ae3f0,135005,145825,0,10,10820,15,15
0afcd846,337105,337485,6,10,380,15,15
05b6afb7,337275,337845,7,5,570,15,15
019a4e4a,337135,338235,10,1,1100,15,15
0c5a8a1b,337235,338595,11,12,1360,15,15
0c51e0be,337295,338985,14,12,1690,15,15
055a98e0,337245,339345,0,5,2100,15,15
033cfca1,337205,339705,1,3,2500,15,15
07e5ebd4,337075,340095,4,7,3020,15,15
040e5367,337445,340485,7,4,3040,15,15
05879a9a,337225,340875,10,5,3650,15,15
0414875b,337455,341235,11,4,3780,15,15
06290ef1,337365,341665,1,6,4300,15,15
008568fe,539085,539545,14,0,460,15,15
009b0c28,539605,540185,8,0,580,15,15
084e02da,539495,540555,10,8,1060,15,15
0dcf61e0,539675,540985,0,13,1310,15,15
03535248,1015,1415,8,3,400,1,9
0295e818,12045,12465,1,2,420,1,9
034d6094,23035,23525,4,3,490,1,9
05056637,34085,34485,2,5,400,1,9
08f998d5,34185,34875,5,8,690,1,9
057cd0d0,34455,35235,6,5,780,1,9
013e3015,34365,35595,7,1,1230,1,9
05056637,34085,36005,2,5,1920,1,9
08f998d5,34185,36395,5,8,2210,1,9
07784c52,135005,135385,2,7,380,1,9
063d2aa6,135005,135745,6,6,740,1,9
03ff7e52,135005,136105,2,3,1100,1,9
013f1766,135005,136465,6,1,1460,1,9
02dcd3d6,135005,136825,6,2,1820,1,9
04457ed2,135005,137185,2,4,2180,1,9
06df78c5,135005,137545,5,6,2540,1,9
02de9f94,135005,137905,4,2,2900,1,9
02724c68,135005,138265,8,2,3260,1,9
022d6126,337065,337475,6,2,410,1,9
08cdb8f1,539075,539625,1,8,550,1,9
02535241,1015,1405,1,2,390,6,3
0095e811,12035,12415,1,0,380,6,3
024d6091,23015,23405,1,2,390,6,3
003f1762,34185,34755,1,0,570,6,3
01784c51,34365,35475,0,1,1110,6,3
013d2aa2,34375,36195,2,1,1820,6,3
022d6121,135005,135385,1,2,380,6,3
028495c1,135005,135745,1,2,740,6,3
00b22802,135005,136105,2,0,1100,6,3
0107ae80,135005,136465,0,1,1460,6,3
02f62631,135005,136825,1,2,1820,6,3
0003e961,135005,137185,1,0,2180,6,3
01fdd6b2,337095,337515,2,1,420,6,3
02572cf1,438105,438535,1,2,430,6,3
029650a0,438275,438905,0,2,630,6,3
02449231,438195,439265,1,2,1070,6,3
06535244,1065,1515,4,6,450,3,9
0495e811,12095,12605,8,4,510,3,9
02056633,23155,24015,3,2,860,3,9
00f998d7,34145,34545,5,0,400,3,9
023e3017,34415,34915,7,2,500,3,9
0197b0d4,34085,35285,0,1,1200,3,9
05284652,34225,35645,1,5,1420,3,9
003f1762,34525,36005,2,0,1480,3,9
007cd0d2,34425,36365,3,0,1940,3,9
08457ed0,34685,36725,4,8,2040,3,9
01ff7e55,35095,37085,5,1,1990,3,9
00cdb8f8,35365,37445,6,0,2080,3,9
01de9f94,34825,37805,7,1,2980,3,9
08272776,35185,38175,0,8,2990,3,9
02784c57,34935,38535,1,2,3600,3,9
05df78c3,34745,38895,2,5,4150,3,9
013d2aa5,35035,39265,4,1,4230,3,9
01de9f94,34825,39655,7,1,4830,3,9
0263eae3,135005,135385,3,2,380,3,9
02449238,135005,135745,8,2,740,3,9
0514c3c6,135005,136105,6,5,1100,3,9
06a4ec58,135005,136465,8,6,1460,3,9
08b582d8,135005,136825,8,8,1820,3,9
073870a3,135005,137185,3,7,2180,3,9
01845aa2,135005,137545,2,1,2540,3,9
083b8131,135005,137905,1,8,2900,3,9
08fdd6b0,135005,138265,0,8,3260,3,9
050f3786,337015,337475,6,5,460,3,9
02a12893,539055,539485,3,2,430,3,9
0050deb8,539065,539915,8,0,850,3,9
04535240,1095,1555,0,4,460,5,5
004d6093,12115,12485,1,0,370,5,5
00056634,12205,12875,4,0,670,5,5
0497b0d3,23075,23525,3,4,450,5,5
01284653,23225,23955,3,1,730,5,5
00dcd3d4,34325,34795,4,0,470,5,5
033f1761,34285,35155,0,3,870,5,5
00457ed0,34415,35515,1,0,1100,5,5
047cd0d3,34215,35875,2,4,1660,5,5
03df78c4,34515,36595,4,3,2080,5,5
04696ce4,35025,36955,0,4,1930,5,5
0207ae81,35115,37315,1,2,2200,5,5
043870a1,35405,37675,2,4,2270,5,5
0462ad53,135005,135385,3,4,380,5,5
00e618a2,135005,136105,2,0,1100,5,5
0350deb3,135005,136465,3,3,1460,5,5
0103e963,135005,136825,3,1,1820,5,5
00fe91d4,135005,137185,4,0,2180,5,5
0114c3c0,135005,137545,0,1,2540,5,5
020f3784,135005,137905,4,2,2900,5,5
00513ae0,135005,138265,0,0,3260,5,5
022554f1,337055,337475,1,2,420,5,5
033327e1,337185,337905,1,3,720,5,5
00307623,438105,438485,3,0,380,5,5
021559f1,539145,539625,1,2,480,5,5
00535243,1015,1495,3,0,480,11,6
0195e813,12065,12835,2,1,770,11,6
0197b0d3,12155,13195,3,1,1040,11,6
014d6095,12075,13565,5,1,1490,11,6
01f998d1,12235,13925,0,1,1690,11,6
01752121,12295,14655,3,1,2360,11,6
017cd0d0,12375,15045,0,1,2670,11,6
033f1764,23105,23525,4,3,420,11,6
053d2aa4,23525,23975,4,5,450,11,6
03272775,34105,34565,0,3,460,11,6
04cdb8f5,34205,34925,1,4,720,11,6
042d6120,34145,35645,3,4,1500,11,6
02696ce5,34315,36005,4,2,1690,11,6
03b22803,34835,36365,5,3,1530,11,6
02a4ec54,34425,36725,0,2,2300,11,6
043870a3,34825,37085,1,4,2260,11,6
03c380d1,35085,37445,2,3,2360,11,6
02069f24,34235,37805,3,2,3570,11,6
0374a024,35355,38525,5,3,3170,11,6
027d6532,35115,38885,0,2,3770,11,6
048bdf22,35795,39245,1,4,3450,11,6
05e618a0,35815,39605,2,5,3790,11,6
0414c3c5,35735,39965,3,4,4230,11,6
0412f962,135005,135385,2,4,380,11,6
00bf6d35,135005,135745,5,0,740,11,6
01599fa5,135005,136105,5,1,1100,11,6
05b34d85,135005,136465,5,5,1460,11,6
03241855,135005,136825,5,3,1820,11,6
059e7395,135005,137545,5,5,2540,11,6
01a0c8e1,135005,137905,1,1,2900,11,6
01b36cb2,135005,138265,2,1,3260,11,6
0579a0b3,135005,138625,3,5,3620,11,6
055fb4c2,135005,138985,2,5,3980,11,6
00ec0d73,135005,139345,3,0,4340,11,6
0540cd02,337285,337855,2,5,570,11,6
02daddc3,337455,338215,3,2,760,11,6
051ff444,337185,338575,4,5,1390,11,6
04fcf0e5,337405,338935,5,4,1530,11,6
03f72fd0,337555,339295,0,3,1740,11,6
04102c31,337595,339655,1,4,2060,11,6
05ebc9a3,337495,340025,3,5,2530,11,6
0090b2a4,337295,340385,4,0,3090,11,6
059e94e4,438105,438795,4,5,690,11,6
0165d932,539285,539675,2,1,390,11,6
024bf945,539215,540065,5,2,850,11,6
07535242,1055,1495,2,7,440,16,11
0295e818,12075,12525,3,2,450,16,11
024d6098,12135,12955,8,2,820,16,11
0297b0d2,12325,13315,9,2,990,16,11
02056637,12235,13675,10,2,1440,16,11
03f998d7,23075,23605,7,3,530,16,11
08457ed7,23545,24155,7,8,610,16,11
0a272777,23875,24705,7,10,830,16,11
022d6122,34015,34485,1,2,470,16,11
06f62631,34455,34845,2,6,390,16,11
00696cea,34195,35925,5,0,1730,16,11
0acdb8f4,34055,36285,6,10,2230,16,11
08b22802,34575,36645,7,8,2070,16,11
03421203,34595,37005,8,3,2410,16,11
08726658,34445,37365,9,8,2920,16,11
00b582d3,34385,38095,1,0,3710,16,11
01fdd6b9,34875,38455,2,1,3580,16,11
0763eaea,35075,38815,3,7,3740,16,11
037d653a,34815,39175,4,3,4360,16,11
0674a02a,35015,39535,5,6,4520,16,11
0a449230,35335,39895,6,10,4560,16,11
03fe91d4,35155,40285,9,3,5130,16,11
059650a2,35375,40715,3,5,5340,16,11
0118d886,135005,135385,6,1,380,16,11
07199ba5,135005,135745,5,7,740,16,11
00d80db1,135005,136105,1,0,1100,16,11
03c42733,135005,136465,3,3,1460,16,11
0214c3c7,135005,136825,7,2,1820,16,11
022554f7,135005,137185,7,2,2180,16,11
0ae37893,135005,137545,3,10,2540,16,11
00bf6d31,135005,137905,1,0,2900,16,11
0a292b31,135005,138265,1,10,3260,16,11
0790b2a1,135005,138625,1,7,3620,16,11
0a65d931,135005,138985,1,10,3980,16,11
0a5c4705,135005,139345,5,10,4340,16,11
013ff781,135005,139705,1,1,4700,16,11
051b4980,135005,140065,0,5,5060,16,11
07de6384,135005,140425,4,7,5420,16,11
057be710,135005,140785,0,5,5780,16,11
02d945c8,135005,141145,8,2,6140,16,11
069e7397,135005,141505,7,6,6500,16,11
06bb4a31,135005,141865,1,6,6860,16,11
061ff447,135005,142225,7,6,7220,16,11
08bc4b88,135005,142585,8,8,7580,16,11
0a807694,135005,142945,4,10,7940,16,11
03390867,337075,337495,7,3,420,16,11
08df5fa6,337125,338025,6,8,900,16,11
04794f28,438105,438615,8,4,510,16,11
03521321,438175,439025,1,3,850,16,11
04b6afb3,539375,539785,3,4,410,16,11
0a5a98e1,539355,540295,1,10,940,16,11
02535241,1065,1455,1,2,390,16,3
0195e810,12095,12485,2,1,390,16,3
014d6091,12185,12845,0,1,660,16,3
01056630,12265,13235,0,1,970,16,3
0297b0d0,23055,23445,0,2,390,16,3
01f998d0,23155,23835,0,1,680,16,3
013e3012,34155,35175,0,1,1020,16,3
0107ae81,135005,136465,1,1,1460,16,3
02fdd6b0,135005,136825,0,2,1820,16,3
0050deb0,135005,137185,0,0,2180,16,3
012554f0,337075,337475,0,1,400,16,3
02c603b1,337115,337835,1,2,720,16,3
013327e2,337285,338195,2,1,910,16,3
025fb4c0,337365,338555,0,2,1190,16,3
02307621,337345,338915,1,2,1570,16,3
001559f1,438015,438445,1,0,430,16,3
009a18f1,438105,438835,1,0,730,16,3
01da9f80,539045,539445,0,1,400,16,3
024569f1,539185,539805,1,2,620,16,3
017edc82,539905,540375,2,1,470,16,3
0125a770,539985,540735,0,1,750,16,3
01535240,1005,1395,0,1,390,4,2
0095e810,12105,12505,1,0,400,4,2
01f998d0,34065,34445,0,1,380,4,2
00284651,34135,34805,1,0,670,4,2
01457ed0,34305,35165,0,1,860,4,2
00ff7e50,135005,135385,0,0,380,4,2
01de9f91,135005,135745,1,1,740,4,2
01a4ec50,337125,337825,0,1,700,4,2
0095e812,12055,12465,3,0,410,5,4
004d6090,12155,12835,1,0,680,5,4
00f998d3,34075,34455,2,0,380,5,4
033f1762,34245,35535,1,3,1290,5,4
01df78c0,34425,36265,0,1,1840,5,4
013d2aa2,34625,36985,2,1,2360,5,4
02fdd6b1,135005,135385,1,2,380,5,4
03a4ec51,135005,135745,1,3,740,5,4
03f62632,135005,136105,2,3,1100,5,4
03ccc9d1,135005,136465,1,3,1460,5,4
0063eae0,135005,136825,0,0,1820,5,4
02b582d3,135005,137185,3,2,2180,5,4
03c380d1,135005,137905,1,3,2900,5,4
0114c3c2,337015,337395,2,1,380,5,4
008bdf23,337045,337755,3,0,710,5,4
0350deb2,539335,539735,2,3,400,5,4
014d6092,23015,23425,2,1,410,7,3
013e3012,23395,23815,2,1,420,7,3
007cd0d2,34095,34485,2,0,390,7,3
01457ed1,34185,34845,0,1,660,7,3
003f1761,34125,35205,1,0,1080,7,3
01df78c0,34245,35565,2,1,1320,7,3
0207ae80,35035,36285,1,2,1250,7,3
02e28bd1,35215,37005,0,2,1790,7,3
01b22801,135005,135385,1,1,380,7,3
013b8130,135005,136465,0,1,1460,7,3
02fe91d2,135005,136825,2,2,1820,7,3
01b34d82,337065,337455,2,1,390,7,3
0250deb0,337245,337815,0,2,570,7,3
01bf9c62,438085,438465,2,1,380,7,3
0179a0b2,539245,539645,2,1,400,7,3
0095e811,12035,12465,1,0,430,4,6
00056635,12095,12825,2,0,730,4,6
004d6092,12085,13195,4,0,1110,4,6
0297b0d5,23085,23545,5,2,460,4,6
03752125,34065,34465,1,3,400,4,6
033e3015,34115,34875,5,3,760,4,6
027cd0d5,34205,35325,5,2,1120,4,6
00696ce0,135005,135385,0,0,380,4,6
05e28bd1,135005,135745,1,5,740,4,6
043870a2,135005,136105,2,4,1100,4,6
04272775,135005,137185,5,4,2180,4,6
0003e965,337045,337455,5,0,410,4,6
04c380d2,337115,337845,2,4,730,4,6
05fdd6b1,438205,438695,1,5,490,4,6
0462ad52,438265,439055,2,4,790,4,6
00449231,539195,539685,1,0,490,4,6
09535245,1005,1455,5,9,450,2,10
0095e815,12065,12465,5,0,400,2,10
004d6099,12095,12915,1,0,820,2,10
00056639,23025,23545,9,0,520,2,10
0997b0d5,34055,34445,4,9,390,2,10
05f998d0,34155,35165,6,5,1010,2,10
007cd0d1,34435,35525,7,0,1090,2,10
093e3011,34375,35885,8,9,1510,2,10
04696ce0,35135,36245,9,4,1110,2,10
09752124,34285,36605,0,9,2320,2,10
09272777,34895,36965,1,9,2070,2,10
05ff7e54,34865,37685,3,5,2820,2,10
08724c67,34705,38045,4,8,3340,2,10
03df78c7,34595,38405,5,3,3810,2,10
00e28bd5,35455,38765,6,0,3310,2,10
04457ed0,34555,39125,7,4,4570,2,10
06dcd3d1,34525,39485,8,6,4960,2,10
05f62637,35615,39845,9,5,4230,2,10
093f1765,34515,40205,0,9,5690,2,10
062d6125,34975,40565,1,6,5590,2,10
08069f28,35125,40925,2,8,5800,2,10
049650a3,36425,41285,3,4,4860,2,10
08724c67,34705,41645,4,8,6940,2,10
00e28bd5,35455,42015,6,0,6560,2,10
04457ed0,34555,42375,7,4,7820,2,10
06dcd3d1,34525,42735,8,6,8210,2,10
05f62637,35615,43095,9,5,7480,2,10
09e618a6,135005,135385,6,9,380,2,10
05b34d89,135005,135745,9,5,740,2,10
02a12899,135005,136105,9,2,1100,2,10
07265b69,135005,136465,9,7,1460,2,10
06513ae1,135005,136825,1,6,1820,2,10
04fdd2a8,135005,137185,8,4,2180,2,10
007be716,135005,137545,6,0,2540,2,10
072554f5,135005,137905,5,7,2900,2,10
006333a7,135005,138265,7,0,3260,2,10
0714c3c7,135005,138625,7,7,3620,2,10
0799bf11,337075,337575,1,7,500,2,10
08a4b152,337055,337935,2,8,880,2,10
06c4bd92,438035,438425,2,6,390,2,10
04307620,438125,438915,0,4,790,2,10
035fb4c2,539085,539475,2,3,390,2,10
06535241,1095,1495,1,6,400,4,7
0695e813,12095,12505,1,6,410,4,7
064d6095,12185,12875,3,6,690,4,7
06056630,12225,13235,4,6,1010,4,7
03f998d6,23095,23465,6,3,370,4,7
01284656,23175,23935,6,1,760,4,7
053e3013,34065,34465,6,5,400,4,7
017cd0d0,34125,34825,0,1,700,4,7
00457ed4,34245,35185,1,0,940,4,7
043f1762,34145,35545,2,4,1400,4,7
04752125,34045,35905,3,4,1860,4,7
05cdb8f2,34805,36265,4,5,1460,4,7
02df78c5,34265,36625,5,2,2360,4,7
00dcd3d3,34155,36985,6,0,2830,4,7
032d6122,34725,37345,0,3,2620,4,7
05de9f93,34365,37705,1,5,3340,4,7
06069f24,34835,38065,2,6,3230,4,7
04a4ec56,35075,38425,3,4,3350,4,7
05b582d2,35255,38785,4,5,3530,4,7
04c380d3,35855,39145,5,4,3290,4,7
01f62636,35375,39505,6,1,4130,4,7
04845aa6,35675,39865,0,4,4190,4,7
06726655,35335,40225,1,6,4890,4,7
06069f24,34835,40585,2,6,5750,4,7
03449232,36385,41305,4,3,4920,4,7
062554f6,135005,135385,6,6,380,4,7
00a4b155,135005,135745,5,0,740,4,7
055fb4c0,135005,136105,0,5,1100,4,7
00d60b70,135005,136465,0,0,1460,4,7
03e37895,135005,136825,5,3,1820,4,7
02265b60,135005,137185,0,2,2180,4,7
04fdd2a3,135005,137545,3,4,2540,4,7
05d7f0c4,337045,337435,4,5,390,4,7
03ccec22,438055,438455,2,3,400,4,7
067edc83,438065,438815,3,6,750,4,7
049e7392,539215,539615,2,4,400,4,7
025816d5,539205,540005,5,2,800,4,7
01535240,1045,1435,0,1,390,6,2
0195e810,12045,12445,0,1,400,6,2
01f998d1,12285,12825,0,1,540,6,2
01284650,23105,23485,0,1,380,6,2
00752121,34025,34425,1,0,400,6,2
00dcd3d0,34345,35145,1,0,800,6,2
01724c60,34555,35505,0,1,950,6,2
00cdb8f0,34905,35865,1,0,960,6,2
01724c60,34555,36225,0,1,1670,6,2
003b8130,135005,135385,0,0,380,6,2
013870a0,135005,135745,0,1,740,6,2
01572cf0,438085,438475,0,1,390,6,2
0114c3c0,539145,539685,0,1,540,6,2
0b535242,1015,1675,2,11,660,4,16
0295e81e,12075,12565,12,2,490,4,16
034d6097,23025,23465,7,3,440,4,16
0a97b0d5,34025,34545,11,10,520,4,16
09056636,34015,34935,14,9,920,4,16
05724c69,34595,35295,15,5,700,4,16
0d284654,34185,35655,0,13,1470,4,16
0fa4ec50,35175,36015,1,15,840,4,16
073f176a,34345,36375,2,7,2030,4,16
0c7cd0d6,34315,36735,3,12,2420,4,16
012d612e,34925,37105,5,1,2180,4,16
053d2aa9,34685,37465,6,5,2780,4,16
0675212e,34235,37825,7,6,3590,4,16
073e301a,34285,38185,8,7,3900,4,16
01069f21,34955,38915,11,1,3960,4,16
03784c54,34615,39275,12,3,4660,4,16
07de9f9a,34575,39635,13,7,5060,4,16
0ddcd3d3,34375,39995,14,13,5620,4,16
0c726656,35445,40355,15,12,4910,4,16
0f3870a5,35635,40715,0,15,5080,4,16
08845aa8,35815,41075,1,8,5260,4,16
0307ae85,35125,41435,2,3,6310,4,16
09e28bda,35315,41795,3,9,6480,4,16
0c03e96c,35995,42165,5,12,6170,4,16
0df62635,35535,42525,6,13,6990,4,16
028495c6,35255,42895,8,2,7640,4,16
033b8137,36045,43305,12,3,7260,4,16
09c380df,36115,43665,13,9,7550,4,16
0cfdd6b5,36245,44055,0,12,7810,4,16
0f0f3786,135005,135385,6,15,380,4,16
03bf9c62,135005,135745,2,3,740,4,16
0979a0b3,135005,136105,3,9,1100,4,16
02c603b8,135005,136465,8,2,1460,4,16
0a99bf16,135005,136825,6,10,1820,4,16
0f1559ff,135005,137185,15,15,2180,4,16
034569f3,135005,137545,3,3,2540,4,16
0be32493,135005,137905,3,11,2900,4,16
0f12f96c,135005,138265,12,15,3260,4,16
0e25a77e,135005,138625,14,14,3620,4,16
0b5816d1,135005,138985,1,11,3980,4,16
0392f853,135005,139345,3,3,4340,4,16
052ae3f0,135005,139705,0,5,4700,4,16
0874a026,135005,140065,6,8,5060,4,16
0a44923a,135005,140425,10,10,5420,4,16
058bdf27,135005,140785,7,5,5780,4,16
0bbb4a39,337145,337535,9,11,390,4,16
0edbc26f,337045,337985,15,14,940,4,16
02617731,337105,338355,1,2,1250,4,16
03292b3e,438115,438645,14,3,530,4,16
059a82f0,438015,439015,0,5,1000,4,16
09b36cba,539245,539795,10,9,550,4,16
05535247,1055,1595,7,5,540,16,11
084d6096,12095,12505,2,8,410,16,11
0895e818,12045,12895,5,8,850,16,11
08056633,12115,13645,9,8,1530,16,11
08f998d8,12225,14005,10,8,1780,16,11
083e3014,12335,14455,5,8,2120,16,11
0a3f1765,23045,23565,5,10,520,16,11
0aff7e55,23505,24115,5,10,610,16,11
04272773,34095,34475,0,4,380,16,11
02069f2a,34295,34885,4,2,590,16,11
01b582d8,34615,35245,5,1,630,16,11
01cdb8f9,34225,35605,6,1,1380,16,11
06696ce0,34375,35965,7,6,1590,16,11
0703e966,34845,36325,8,7,1480,16,11
042d6125,34155,36685,9,4,2530,16,11
0a07ae84,34405,37055,0,10,2650,16,11
06f62630,34675,37415,1,6,2740,16,11
02845aa1,34825,38185,6,2,3360,16,11
033b8130,34915,38905,8,3,3990,16,11
00e28bd0,34605,39265,9,0,4660,16,11
044266d3,135005,135385,3,4,380,16,11
001451c2,135005,135745,2,0,740,16,11
06761377,135005,136105,7,6,1100,16,11
05578a19,135005,136465,9,5,1460,16,11
057d653a,135005,136825,10,5,1820,16,11
07a12893,135005,137185,3,7,2180,16,11
09c4bd93,135005,137545,3,9,2540,16,11
0ad7f0c8,135005,137905,8,10,2900,16,11
02caf2a0,135005,138265,0,2,3260,16,11
0a8db5a2,135005,138625,2,10,3620,16,11
02102c31,135005,138985,1,2,3980,16,11
0ac9c2e6,135005,139345,6,10,4340,16,11
004f61a6,135005,139705,6,0,4700,16,11
02b80a86,135005,140425,6,2,5420,16,11
02b34d88,135005,140785,8,2,5780,16,11
07a4b153,135005,141145,3,7,6140,16,11
057fc518,135005,141505,8,5,6500,16,11
07b4b499,135005,141865,9,7,6860,16,11
09b36cb2,135005,142225,2,9,7220,16,11
02ebc9a8,135005,142585,8,2,7580,16,11
09cde4d6,135005,142945,6,9,7940,16,11
015ff9e3,337025,337415,3,1,390,16,11
05de6384,337085,337775,4,5,690,16,11
0afa8795,337125,338135,5,10,1010,16,11
024e3c86,337155,338495,6,2,1340,16,11
08fd3927,337645,338855,7,8,1210,16,11
0a0c96b8,337415,339215,8,10,1800,16,11
0a6abc49,337575,339575,9,10,2000,16,11
08345caa,337235,339935,10,8,2700,16,11
057aec71,337425,340305,1,5,2880,16,11
04f41132,337325,340665,2,4,3340,16,11
06bddb64,337525,341035,4,6,3510,16,11
0259dba6,337535,341405,6,2,3870,16,11
05295b98,337585,341775,8,5,4190,16,11
07b3b7f9,337735,342135,9,7,4400,16,11
05df5fa2,438175,438565,2,5,390,16,11
09521327,438325,438995,7,9,670,16,11
03794f28,438235,439355,8,3,1120,16,11
08e5ebd1,539035,539485,1,8,450,16,11
050e5364,539605,540575,4,5,970,16,11
055e7886,539815,540945,6,5,1130,16,11
098568f8,539725,541315,8,9,1590,16,11
04535242,1075,1515,2,4,440,6,14
0b056633,12195,12605,6,11,410,6,14
0b95e810,12105,12995,9,11,890,6,14
0b4d609c,12155,13385,12,11,1230,6,14
0497b0d3,23085,23545,3,4,460,6,14
0128465b,34145,34585,5,1,440,6,14
077cd0d4,34305,34945,6,7,640,6,14
06784c5a,34675,35305,7,6,630,6,14
0bf998d6,34095,35665,8,11,1570,6,14
04724c61,34605,36055,11,4,1450,6,14
0c3e3017,34245,36785,0,12,2540,6,14
0ddf78ca,34495,37145,1,13,2650,6,14
06dcd3da,34385,37505,2,6,3120,6,14
02457ed2,34455,37865,3,2,3410,6,14
0b07ae87,35195,38225,4,11,3030,6,14
043f1765,34335,38585,5,4,4250,6,14
08de9f90,34595,38945,6,8,4350,6,14
0027277c,34915,39305,7,0,4390,6,14
01f62637,35535,39665,8,1,4130,6,14
08421201,35715,40055,11,8,4340,6,14
0314c3c0,36665,40785,0,3,4120,6,14
0630aca9,36605,41145,1,6,4540,6,14
05e28bd4,35415,41505,2,5,6090,6,14
00572cf5,36445,41865,3,0,5420,6,14
0ce618a5,36725,42225,4,12,5500,6,14
0d62ad5a,36155,42585,5,13,6430,6,14
01f62637,35535,43315,8,1,7780,6,14
01ff29c1,135005,135385,1,1,380,6,14
09292b3d,135005,135745,13,9,740,6,14
0a8db5a5,135005,136105,5,10,1100,6,14
04e94df9,135005,136465,9,4,1460,6,14
09fcf0ed,135005,136825,13,9,1820,6,14
0db34d86,135005,137185,6,13,2180,6,14
032554fd,135005,137905,13,3,2900,6,14
0dc4bd9a,135005,138265,10,13,3260,6,14
05d60b78,135005,138625,8,5,3620,6,14
0a33ed07,135005,138985,7,10,3980,6,14
087edc8c,135005,139345,12,8,4340,6,14
029e7392,135005,139705,2,2,4700,6,14
0ab4b499,135005,140065,9,10,5060,6,14
04bb4a3c,135005,140425,12,4,5420,6,14
02b36cb4,135005,140785,4,2,5780,6,14
0cfb6659,135005,141145,9,12,6140,6,14
0090b2ad,135005,141505,13,0,6500,6,14
04102c38,135005,141865,8,4,6860,6,14
07265b68,135005,142225,8,7,7220,6,14
067be715,135005,142585,5,6,7580,6,14
03a4b154,135005,142945,4,3,7940,6,14
009a18f7,135005,143305,7,0,8300,6,14
0ce3789b,135005,143665,11,12,8660,6,14
09d7f0cd,135005,144025,13,9,9020,6,14
0c5007e5,135005,144385,5,12,9380,6,14
0a488788,135005,144745,8,10,9740,6,14
01f38866,135005,145105,6,1,10100,6,14
071340a8,337095,337515,8,7,420,6,14
0297667d,337075,337945,13,2,870,6,14
049e94e0,337035,338305,0,4,1270,6,14
0afb9b64,337125,338715,4,10,1590,6,14
0be8a387,337185,339105,7,11,1920,6,14
0065d936,438225,438655,6,0,430,6,14
054bf94c,438185,439105,12,5,920,6,14
0af2c043,438245,439535,3,10,1290,6,14
087ca596,438345,439925,6,8,1580,6,14
09b69db3,539095,539505,3,9,410,6,14
04535243,1075,1535,3,4,460,12,7
004d6092,12135,12515,1,0,380,12,7
0095e811,12085,12875,2,0,790,12,7
00056633,12205,13345,2,0,1140,12,7
0197b0d5,23035,23445,5,1,410,12,7
063f1765,23435,23915,5,6,480,12,7
00dcd3d2,34095,34475,6,0,380,12,7
05457ed6,34185,34835,0,5,650,12,7
00ff7e54,34605,35195,1,0,590,12,7
03724c65,34405,35555,2,3,1150,12,7
04df78c0,34285,35915,3,4,1630,12,7
05069f26,34865,36275,4,5,1410,12,7
02de9f91,34335,36635,5,2,2300,12,7
0007ae84,34985,36995,6,0,2010,12,7
05421202,35555,37355,0,5,1800,12,7
03272774,34675,37715,1,3,3040,12,7
017d6532,35865,38435,3,1,2570,12,7
06572cf2,36255,38795,4,6,2540,12,7
019650a5,36435,39155,5,1,2720,12,7
018bdf21,36705,39515,6,1,2810,12,7
0303e966,35795,39885,1,3,4090,12,7
0414c3c1,36605,40245,2,4,3640,12,7
06fe91d6,36205,40605,3,6,4400,12,7
0530aca4,36515,40965,4,5,4450,12,7
01da9f85,135005,135385,5,1,380,12,7
02ccec21,135005,135745,1,2,740,12,7
06a595b6,135005,136105,6,6,1100,12,7
02ae2b50,135005,136825,0,2,1820,12,7
04241850,135005,137545,0,4,2540,12,7
0112f962,135005,137905,2,1,2900,12,7
0292f853,135005,138265,3,2,3260,12,7
06617731,135005,138625,1,6,3620,12,7
0436cda5,135005,138985,5,4,3980,12,7
00f72fd6,135005,139345,6,0,4340,12,7
0279a0b2,135005,139705,2,2,4700,12,7
041559f4,135005,140065,4,4,5060,12,7
019e94e0,337045,337495,0,1,450,12,7
04e8a383,337285,338225,3,4,940,12,7
011340a5,337195,338595,5,1,1400,12,7
05fb9b60,337235,338965,0,5,1730,12,7
00187796,438095,438565,6,0,470,12,7
04bc4b82,438145,438955,2,4,810,12,7
03b69db4,539275,540055,4,3,780,12,7
01f2c046,539215,540425,6,1,1210,12,7
05535249,1025,1415,9,5,390,7,11
0595e812,12045,12605,7,5,560,7,11
054d609a,12105,12995,10,5,890,7,11
05f998d6,12255,13365,1,5,1110,7,11
05056631,12165,13725,2,5,1560,7,11
05284656,12295,14095,4,5,1800,7,11
0597b0d9,12215,14485,7,5,2270,7,11
05752124,12395,14975,4,5,2580,7,11
077cd0d3,23085,23525,3,7,440,7,11
03724c69,34095,34475,0,3,380,7,11
02de9f98,34045,34835,1,2,790,7,11
092d6122,34415,35205,3,9,790,7,11
01784c54,34165,35565,4,1,1400,7,11
0a272778,34365,35925,5,10,1560,7,11
08ff7e58,34355,36285,6,8,1930,7,11
08cdb8f9,34465,36645,7,8,2180,7,11
0763eae7,35465,37005,8,7,1540,7,11
073d2aa0,34255,37365,9,7,3110,7,11
05e28bd3,34835,37725,10,5,2890,7,11
0a069f21,34555,38085,0,10,3530,7,11
06b22803,34975,38445,1,6,3470,7,11
0003e96a,35115,38805,2,0,3690,7,11
0a845aa7,35025,39165,3,10,4140,7,11
03a4ec56,34735,39525,4,3,4790,7,11
0a74a026,35365,39885,5,10,4520,7,11
0162ad54,35345,40245,6,1,4900,7,11
08b582da,34885,40605,7,8,5720,7,11
02c380d9,35195,40975,9,2,5780,7,11
087d6537,35295,41335,10,8,6040,7,11
023870a7,34965,41695,0,2,6730,7,11
03fe91d8,35545,42065,2,3,6520,7,11
049e7397,135005,135385,7,4,380,7,11
072ae3f7,135005,135745,7,7,740,7,11
01dbc269,135005,136105,9,1,1100,7,11
018fdf75,135005,136465,5,1,1460,7,11
08449232,135005,136825,2,8,1820,7,11
06b34d81,135005,137185,1,6,2180,7,11
01502bc5,135005,137545,5,1,2540,7,11
006333a4,135005,137905,4,0,2900,7,11
021559f3,135005,138265,3,2,3260,7,11
03ccec20,135005,138985,0,3,3980,7,11
08a595b0,135005,139345,0,8,4340,7,11
04ff29c8,135005,139705,8,4,4700,7,11
0a8565fa,135005,140065,10,10,5060,7,11
042e2ed4,135005,140425,4,4,5420,7,11
08e618a0,135005,140785,0,8,5780,7,11
02bf9c65,135005,141145,5,2,6140,7,11
06307621,135005,141865,1,6,6860,7,11
05d945c6,135005,142225,6,5,7220,7,11
095007e6,135005,142945,6,9,7940,7,11
0a90b2a3,337065,337635,3,10,570,7,11
016adab3,337165,338185,3,1,1020,7,11
03f72fd5,438155,438575,5,3,420,7,11
01daddc7,438125,438945,7,1,820,7,11
08ebc9aa,438145,439335,10,8,1190,7,11
05eed567,539135,539625,7,5,490,7,11
04535245,1055,1535,5,4,480,5,6
0395e810,12105,12545,5,3,440,5,6
0397b0d5,12285,12915,1,3,630,5,6
034d6091,12185,13275,2,3,1090,5,6
03f998d4,12345,13665,5,3,1320,5,6
02284653,23065,23505,3,2,440,5,6
05752125,34025,34445,0,5,420,5,6
013e3012,34115,34835,3,1,720,5,6
03df78c0,34365,35195,4,3,830,5,6
023f1762,34245,35555,5,2,1310,5,6
02724c62,34425,35915,0,2,1490,5,6
04784c53,34485,36275,1,4,1790,5,6
013d2aa3,34575,36635,2,1,2060,5,6
01069f25,34785,36995,3,1,2210,5,6
03726651,35135,37355,4,3,2220,5,6
04421203,35395,37715,5,4,2320,5,6
02724c62,34425,38075,0,2,3650,5,6
0030aca0,36235,38435,1,0,2200,5,6
00a4ec51,34965,38795,2,0,3830,5,6
0103e960,35525,39155,3,1,3630,5,6
00845aa0,35445,39515,4,0,4070,5,6
01449233,36135,39875,5,1,3740,5,6
02724c62,34425,40235,0,2,5810,5,6
01a4b153,135005,135385,3,1,380,5,6
031559f4,135005,135745,4,3,740,5,6
02d945c3,135005,136105,3,2,1100,5,6
030f3781,135005,136465,1,3,1460,5,6
05513ae2,135005,136825,2,5,1820,5,6
03241852,135005,137185,2,3,2180,5,6
02307622,135005,137545,2,2,2540,5,6
03d60b70,135005,137905,0,3,2900,5,6
04e32491,135005,138265,1,4,3260,5,6
02265b61,135005,138625,1,2,3620,5,6
0479a0b0,135005,138985,0,4,3980,5,6
016333a4,135005,139345,4,1,4340,5,6
017fc515,337045,337455,5,1,410,5,6
0212f963,337095,337865,3,2,770,5,6
02ccec23,438075,438485,3,2,410,5,6
057edc80,438105,438875,0,5,770,5,6
055007e4,539065,539515,4,5,450,5,6
005816d1,539085,539905,1,0,820,5,6
0195e810,12085,12485,0,1,400,8,2
0197b0d0,12225,13205,0,1,980,8,2
01de9f90,34115,34485,0,1,370,8,2
01272770,34375,35205,0,1,830,8,2
018495c0,34975,35925,0,1,950,8,2
018495c0,34975,36645,0,1,1670,8,2
000f3780,135005,135385,0,0,380,8,2
00502bc1,135005,136105,1,0,1100,8,2
014b3410,135005,136465,0,1,1460,8,2
003327e1,337305,337805,1,0,500,8,2
00a4b151,337405,338525,1,0,1120,8,2
00307621,438135,438825,1,0,690,8,2
005fb4c1,539015,539435,1,0,420,8,2
04535242,1025,1495,2,4,470,5,11
0095e818,12075,12505,2,0,430,5,11
004d6093,12125,12955,8,0,830,5,11
00056633,12155,13315,9,0,1160,5,11
0697b0d5,23045,23565,5,6,520,5,11
01752125,23145,24115,5,1,970,5,11
0a3f176a,34145,34525,3,10,380,5,11
02784c52,34495,34895,5,2,400,5,11
073d2aa1,34555,35255,6,7,700,5,11
06de9f91,34355,35625,8,6,1270,5,11
047cd0d2,34125,36355,0,4,2230,5,11
0adcd3d7,34195,36715,1,10,2520,5,11
07df78c9,34295,37075,2,7,2780,5,11
08724c61,34445,37435,3,8,2990,5,11
00457ed3,34225,37905,10,0,3680,5,11
01ff7e56,34565,38265,0,1,3700,5,11
05a12897,135005,135385,7,5,380,5,11
04502bca,135005,135745,10,4,740,5,11
0a2554f7,135005,136105,7,10,1100,5,11
08a4ec51,135005,137185,1,8,2180,5,11
05f62638,135005,137545,8,5,2540,5,11
09ccc9d4,135005,137905,4,9,2900,5,11
02572cf6,135005,138625,6,2,3620,5,11
058bdf2a,135005,138985,10,5,3980,5,11
017be718,135005,139705,8,1,4700,5,11
083327e4,135005,140065,4,8,5060,5,11
07b582d5,135005,141145,5,7,6140,5,11
03421203,135005,141505,3,3,6500,5,11
0363eae9,135005,142225,9,3,7220,5,11
09b34d87,135005,142945,7,9,7940,5,11
079a18f6,337085,337475,6,7,390,5,11
07da9f84,337145,337985,4,7,840,5,11
034569f6,438075,438545,6,3,470,5,11
08bc05b9,438175,438935,9,8,760,5,11
09d60b71,438055,439325,1,9,1270,5,11
02d945c4,438145,439715,4,2,1570,5,11
09ec0d76,539215,539685,6,9,470,5,11
01535240,1095,1485,0,1,390,4,2
01284650,34045,34415,0,1,370,4,2
007cd0d0,34305,34775,1,0,470,4,2
009650a1,135005,135385,1,0,380,4,2
000f3781,337035,337415,1,0,380,4,2
0150deb0,337215,337775,0,1,560,4,2
00a12891,337125,338135,1,0,1010,4,2
00535245,1065,1535,5,0,470,2,6
0395e812,12025,12445,0,3,420,2,6
054d6092,23105,23485,2,5,380,2,6
04056632,23205,23935,2,4,730,2,6
0397b0d2,34055,34445,0,3,390,2,6
027cd0d4,34335,34805,1,2,470,2,6
01dcd3d3,34455,35525,3,1,1070,2,6
02f998d3,34125,35885,4,2,1760,2,6
04284652,34155,36245,5,4,2090,2,6
053d2aa4,34925,36605,0,5,1680,2,6
00a4ec51,35285,37325,2,0,2040,2,6
04df78c3,34645,37685,3,4,3040,2,6
023e3012,34235,38045,4,2,3810,2,6
00752120,34175,38405,5,0,4230,2,6
053d2aa4,34925,38765,0,5,3840,2,6
00a4ec51,35285,39485,2,0,4200,2,6
04df78c3,34645,39845,3,4,5200,2,6
0062ad55,135005,135385,5,0,380,2,6
0363eae4,135005,135745,4,3,740,2,6
04572cf2,135005,136105,2,4,1100,2,6
043b8130,135005,136825,0,4,1820,2,6
047d6534,135005,137185,4,4,2180,2,6
0330aca1,337105,337495,1,3,390,2,6
0314c3c5,438065,438515,5,3,450,2,6
048bdf20,438105,438875,0,4,770,2,6
03e618a5,539065,539515,5,3,450,2,6
08535240,1035,1435,0,8,400,14,9
00284654,12335,12815,2,0,480,14,9
007cd0d5,12535,13175,3,0,640,14,9
00056638,12115,13535,4,0,1420,14,9
0095e817,12025,13895,5,0,1870,14,9
00f998d5,12285,14255,6,0,1970,14,9
00df78c8,12735,14615,7,0,1880,14,9
00457ed3,12665,15345,1,0,2680,14,9
003f1760,12605,15755,5,0,3150,14,9
05de9f97,23025,23405,7,5,380,14,9
06272777,23295,23915,7,6,620,14,9
002d6128,34075,34925,7,0,850,14,9
04e28bd6,34375,35285,8,4,910,14,9
07b22801,34665,35645,0,7,980,14,9
0307ae86,34255,36005,1,3,1750,14,9
01069f23,34145,36365,2,1,2220,14,9
04a4ec53,34305,36725,3,4,2420,14,9
078495c6,34335,37445,5,7,3110,14,9
003870a7,34595,37805,6,0,3210,14,9
00fe91d1,35185,38165,7,0,2980,14,9
007d6534,34975,38525,8,0,3550,14,9
0763eae3,35145,38885,0,7,3740,14,9
06572cf0,35225,39245,1,6,4020,14,9
069650a4,35385,39975,4,6,4590,14,9
02fdd6b4,34985,40335,5,2,5350,14,9
00421204,34715,40695,6,0,5980,14,9
04449232,35295,41055,7,4,5760,14,9
00ebc9a6,135005,135385,6,0,380,14,9
037ca594,135005,135745,4,3,740,14,9
0518d884,135005,136105,4,5,1100,14,9
0214c3c3,135005,136465,3,2,1460,14,9
047be711,135005,136825,1,4,1820,14,9
012ed3d5,135005,137545,5,1,2540,14,9
06f38863,135005,137905,3,6,2900,14,9
088db5a8,135005,138265,8,8,3260,14,9
05807691,135005,138985,1,5,3980,14,9
027c63d5,135005,139345,5,2,4340,14,9
06fdd2a8,135005,139705,8,6,4700,14,9
069a18f3,135005,140065,3,6,5060,14,9
017edc84,135005,140425,4,1,5420,14,9
07caf2a8,135005,140785,8,7,5780,14,9
03fcf0e1,135005,141505,1,3,6500,14,9
03199ba2,337185,337575,2,3,390,14,9
07504734,337085,337945,4,7,860,14,9
074f61a5,337255,338305,5,7,1050,14,9
08ab35e7,337195,338675,7,8,1480,14,9
04000b91,337275,339065,1,4,1790,14,9
05779fa4,337225,339455,4,5,2230,14,9
03761372,539055,539485,2,3,430,14,9
03a9b7e2,539455,539895,2,3,440,14,9
059837d4,539315,540265,4,5,950,14,9
0161ab68,539285,540675,8,1,1390,14,9
08d80db1,539505,541045,1,8,1540,14,9
00535241,1025,1415,1,0,390,9,4
0095e810,12105,12525,2,0,420,9,4
00056631,23045,23425,1,0,380,9,4
01752123,34115,34495,0,1,380,9,4
017cd0d0,34295,35575,3,1,1280,9,4
01dcd3d2,34395,35985,3,1,1590,9,4
00fdd6b2,135005,135385,2,0,380,9,4
01df78c3,135005,135745,3,1,740,9,4
02069f21,135005,136105,1,2,1100,9,4
012d6122,135005,137185,2,1,2180,9,4
00726653,135005,137545,3,0,2540,9,4
01e618a0,337045,337435,0,1,390,9,4
004b3412,337115,337805,2,0,690,9,4
00513ae2,438305,439235,2,0,930,9,4
02c603b3,539365,540125,3,2,760,9,4
01535244,1065,1535,4,1,470,6,5
0095e811,12075,12525,3,0,450,6,5
004d6090,12115,12885,4,0,770,6,5
00056630,12175,13255,1,0,1080,6,5
003f1764,34315,34885,4,0,570,6,5
04dcd3d3,34325,35245,0,4,920,6,5
032d6123,34755,37045,0,3,2290,6,5
03784c54,34555,37405,1,3,2850,6,5
04726654,135005,135385,4,4,380,6,5
01ccc9d0,135005,135745,0,1,740,6,5
0462ad51,135005,136105,1,4,1100,6,5
029650a3,135005,136465,3,2,1460,6,5
04421201,135005,137185,1,4,2180,6,5
017d6530,135005,137545,0,1,2540,6,5
00572cf1,135005,137905,1,0,2900,6,5
00e618a3,135005,138265,3,0,3260,6,5
01e28bd1,135005,138625,1,1,3620,6,5
04265b62,337115,337495,2,4,380,6,5
01502bc4,337275,338215,4,1,940,6,5
0150deb0,337105,338575,0,1,1470,6,5
04bf9c62,337155,338945,2,4,1790,6,5
02fdd2a0,438075,438525,0,2,450,6,5
0379a0b0,438165,438955,0,3,790,6,5
00c603b3,539295,539705,3,0,410,6,5
03535241,1015,1415,1,3,400,9,4
0295e811,12105,12485,0,2,380,9,4
0297b0d2,12255,12845,1,2,590,9,4
02f998d0,12275,13215,3,2,940,9,4
02056633,12245,13575,0,2,1330,9,4
03284651,23065,23505,1,3,440,9,4
03dcd3d1,23375,23915,1,3,540,9,4
03457ed3,34015,34405,0,3,390,9,4
00de9f93,34095,34765,1,0,670,9,4
03069f23,34645,35845,0,3,1200,9,4
02272772,34405,36205,1,2,1800,9,4
023870a3,35175,36575,3,2,1400,9,4
02b22803,35225,36935,0,2,1710,9,4
03726650,35055,37295,1,3,2240,9,4
00fdd2a1,135005,135385,1,0,380,9,4
004b3410,135005,136465,0,0,1460,9,4
023327e2,135005,136825,2,2,1820,9,4
0362ad50,135005,137185,0,3,2180,9,4
038bdf21,135005,137545,1,3,2540,9,4
03513ae2,135005,137905,2,3,2900,9,4
021559f3,337105,337495,3,2,390,9,4
009a18f1,337155,337865,1,0,710,9,4
00d945c2,438085,438475,2,0,390,9,4
034569f0,438075,438845,0,3,770,9,4
01e37890,438235,439255,0,1,1020,9,4
0212f960,539205,540125,0,2,920,9,4
00ccec21,539355,540485,1,0,1130,9,4
02535245,1015,1655,5,2,640,4,15
0695e812,12025,12425,8,6,400,4,15
064d6094,12035,12995,5,6,960,4,15
09056632,23105,23605,2,9,500,4,15
0297b0db,34025,34525,13,2,500,4,15
09dcd3d9,34395,34885,14,9,490,4,15
00284658,34105,35255,1,0,1150,4,15
0b457ed3,34475,35615,2,11,1140,4,15
02f998d3,34085,35975,3,2,1890,4,15
0a7cd0d1,34255,36335,4,10,2080,4,15
008495c3,35465,37055,6,0,1590,4,15
08726651,35675,37415,7,8,1740,4,15
0c2d612d,35085,37775,8,12,2690,4,15
03752129,34155,38135,9,3,3980,4,15
00724c67,34675,38495,10,0,3820,4,15
0e74a02c,36515,38855,11,14,2340,4,15
0a696ce8,35235,39575,13,10,4340,4,15
0c7d6532,36235,40295,0,12,4060,4,15
0edf78c6,34565,40655,1,14,6090,4,15
04e28bd6,35555,41015,2,4,5460,4,15
0eb582d7,35625,41375,3,14,5750,4,15
0142120b,35875,41735,4,1,5860,4,15
07ccc9d6,35985,42095,5,7,6110,4,15
0062ad50,36415,42455,6,0,6040,4,15
0a50deb1,37275,42825,8,10,5550,4,15
023f1765,34355,43185,9,2,8830,4,15
0344923c,36745,43905,11,3,7160,4,15
09cdb8f5,35115,44265,12,9,9150,4,15
07265b68,37325,44625,13,7,7300,4,15
0d9650a2,36845,44985,14,13,8140,4,15
03fe91d9,36625,45715,2,3,9090,4,15
0403e96b,36025,46075,3,4,10050,4,15
0142120b,35875,46435,4,1,10560,4,15
007fc511,135005,135385,1,0,380,4,15
047edc83,135005,135745,3,4,740,4,15
0a5007e1,135005,136105,1,10,1100,4,15
04bf6d3a,135005,136465,10,4,1460,4,15
0cb4b49e,135005,136825,14,12,1820,4,15
01dbc263,135005,137545,3,1,2540,4,15
02292b3a,135005,137905,10,2,2900,4,15
04b36cb2,135005,138265,2,4,3260,4,15
0bfdd2ad,135005,138625,13,11,3620,4,15
052554f8,135005,138985,8,5,3980,4,15
03a4b152,135005,139345,2,3,4340,4,15
075fb4c2,135005,139705,2,7,4700,4,15
02d60b77,135005,140065,7,2,5060,4,15
0ce37890,135005,140425,0,12,5420,4,15
0a2e2ed3,337105,337715,3,10,610,4,15
0b36cda8,438095,438615,8,11,520,4,15
0dfb665b,438105,439005,11,13,900,4,15
04ae2b58,539065,539575,8,4,510,4,15
0a535248,1015,1475,8,10,460,15,12
084d6095,12095,12505,9,8,410,15,12
08056638,12115,12955,3,8,840,15,12
0895e814,12075,13325,5,8,1250,15,12
0b97b0da,23085,23525,10,11,440,15,12
01457eda,23525,24095,10,1,570,15,12
08df78ca,23585,24665,10,8,1080,15,12
0ade9f99,34075,34545,11,10,470,15,12
09784c5b,34195,34935,2,9,740,15,12
053d2aa5,34285,35305,4,5,1020,15,12
092d6127,34515,35695,7,9,1180,15,12
03724c67,34165,36055,8,3,1890,15,12
03272778,34465,36445,11,3,1980,15,12
098495c1,34755,36805,0,9,2050,15,12
06696ce8,34615,37175,2,6,2560,15,12
03a4ec55,34725,37545,4,3,2820,15,12
06069f25,34595,37935,7,6,3340,15,12
0107ae82,34695,38685,11,1,3990,15,12
001559f7,135005,135385,7,0,380,15,12
027edc88,135005,135745,8,2,740,15,12
01563585,135005,136105,5,1,1100,15,12
078db5a8,135005,136465,8,7,1460,15,12
03f72fd5,135005,136825,5,3,1820,15,12
02cde4d8,135005,137185,8,2,2180,15,12
05530c76,135005,137545,6,5,2540,15,12
00779fab,135005,137905,11,0,2900,15,12
033b6cfb,135005,138265,11,3,3260,15,12
0b72665a,135005,138625,10,11,3620,15,12
00513ae2,135005,139345,2,0,4340,15,12
06d7f0c2,135005,139705,2,6,4700,15,12
062ae3fb,135005,140065,11,6,5060,15,12
01b36cb1,135005,140425,1,1,5420,15,12
05daddc7,135005,140785,7,5,5780,15,12
097ca592,135005,141145,2,9,6140,15,12
05199ba0,135005,141865,0,5,6860,15,12
07a9b7e1,135005,142225,1,7,7220,15,12
0b74a025,135005,142945,5,11,7940,15,12
07265b66,135005,143305,6,7,8300,15,12
028d14e4,337045,337435,4,2,390,15,12
09efda95,337175,337795,5,9,620,15,12
02a8ca17,337195,338165,7,2,970,15,12
08bb90e0,337275,338925,0,8,1650,15,12
07fb52a3,438305,438735,3,7,430,15,12
06a1d2a4,438315,439095,4,6,780,15,12
06de6385,438445,439455,5,6,1010,15,12
005ff9e7,438405,439825,7,0,1420,15,12
055f48db,438335,440235,11,5,1900,15,12
0bfa8790,438495,440595,0,11,2100,15,12
050c96b9,539245,539795,9,5,550,15,12
027aec7b,539265,540165,11,2,900,15,12
05535241,1095,1495,1,5,400,13,8
0595e810,12035,12525,2,5,490,13,8
053e3012,12395,12885,3,5,490,13,8
054d6097,12065,13245,4,5,1180,13,8
05056636,12105,13615,6,5,1510,13,8
05457ed0,12625,13975,7,5,1350,13,8
05284656,12295,14335,0,5,2040,13,8
05df78c6,12715,14695,1,5,1980,13,8
053f1763,12475,15055,2,5,2580,13,8
057cd0d4,12445,15425,4,5,2980,13,8
05752127,12385,15835,0,5,3450,13,8
07de9f93,23105,23545,3,7,440,13,8
00724c63,23155,24035,3,0,880,13,8
01784c50,34065,34565,4,1,500,13,8
05cdb8f4,34425,34955,7,5,530,13,8
05726652,34805,35325,1,5,520,13,8
04272773,34245,35685,2,4,1440,13,8
07ff7e55,34215,36045,3,7,1830,13,8
0307ae86,34525,36405,4,3,1880,13,8
00845aa2,35085,36765,5,0,1680,13,8
02a4ec55,34595,37125,6,2,2530,13,8
02069f23,34465,37485,7,2,3020,13,8
053b8135,35225,37845,0,5,2620,13,8
00421201,35015,38205,1,0,3190,13,8
06fe91d2,35535,38565,2,6,3030,13,8
0714c3c3,35775,38925,3,7,3150,13,8
0762ad52,35455,39285,4,7,3830,13,8
01bf9c61,36265,39645,5,1,3380,13,8
0279a0b7,36485,40005,6,2,3520,13,8
01241851,36615,40365,7,1,3750,13,8
02502bc0,36385,40725,0,2,4340,13,8
00fdd2a2,36415,41085,1,0,4670,13,8
077be711,36515,41805,3,7,5290,13,8
00f38861,135005,135385,1,0,380,13,8
0391ae65,135005,135745,5,3,740,13,8
06fcf0e2,135005,136105,2,6,1100,13,8
014bf944,135005,136465,4,1,1460,13,8
02c603b7,135005,137185,7,2,2180,13,8
03d945c7,135005,137545,7,3,2540,13,8
03cdb120,135005,137905,0,3,2900,13,8
058fdf75,135005,138265,5,5,3260,13,8
0290b2a2,135005,138625,2,2,3620,13,8
00187793,135005,138985,3,0,3980,13,8
05371956,135005,139345,6,5,4340,13,8
017a6fd2,135005,139705,2,1,4700,13,8
01d60b76,135005,140065,6,1,5060,13,8
0525a773,135005,140425,3,5,5420,13,8
00caf2a4,135005,140785,4,0,5780,13,8
01e05d54,337055,337435,4,1,380,13,8
054f61a1,337155,337865,1,5,710,13,8
07737964,337265,338255,4,7,990,13,8
0461ab66,438145,438575,6,4,430,13,8
0759f260,438105,438945,0,7,840,13,8
07f0fdc3,539095,539545,3,7,450,13,8
07578a14,539655,540225,4,7,570,13,8
02396505,539785,540585,5,2,800,13,8
00535241,1025,1655,1,0,630,16,16
0695e81c,12025,12405,4,6,380,16,16
064d6097,12055,12765,5,6,710,16,16
06056638,12135,13135,7,6,1000,16,16
063e301f,12375,13505,9,6,1130,16,16
0697b0da,12185,13995,1,6,1810,16,16
06f998df,12235,14365,3,6,2130,16,16
06284653,12265,14725,4,6,2460,16,16
06752121,12355,15315,1,6,2960,16,16
0b7cd0d7,23065,23465,7,11,400,16,16
033d2aa7,23475,24115,7,3,640,16,16
0407ae87,23975,24765,7,4,790,16,16
0fb582d1,34155,34535,10,15,380,16,16
06a4ec5f,34015,34895,11,6,880,16,16
097d653e,34835,35255,12,9,420,16,16
0603e96b,34625,35615,13,6,990,16,16
0172665d,34255,36335,15,1,2080,16,16
0f74a02a,34915,36695,0,15,1780,16,16
058495cf,34085,37055,1,5,2970,16,16
0dccc9da,34575,37775,3,13,3200,16,16
08b22804,34335,38135,4,8,3800,16,16
09c380d7,34815,38495,5,9,3680,16,16
08845aa0,34475,38865,7,8,4390,16,16
007be719,35725,39585,9,0,3860,16,16
0f449236,35035,39945,10,15,4910,16,16
0a42120b,34385,40305,11,10,5920,16,16
09265b61,35525,40675,13,9,5150,16,16
086333ae,35975,41395,15,8,5420,16,16
07572cf0,35005,41755,0,7,6750,16,16
033327e4,35995,42115,1,3,6120,16,16
00513ae4,35555,42475,2,0,6920,16,16
0ec603b4,35935,42835,3,14,6900,16,16
0679a0b0,35675,43195,4,6,7520,16,16
06bf9c6e,35535,43555,5,6,8020,16,16
0c241857,35765,43925,7,12,8160,16,16
0f502bc2,35615,44315,10,15,8700,16,16
0f2554f3,35855,44675,11,15,8820,16,16
08f72fda,135005,135745,10,8,740,16,16
0c0b7d95,135005,136105,5,12,1100,16,16
0f7e408f,135005,136465,15,15,1460,16,16
0f000b99,135005,136825,9,15,1820,16,16
0b409176,135005,137185,6,11,2180,16,16
0befda9d,135005,137545,13,11,2540,16,16
0cbddb66,135005,137905,6,12,2900,16,16
025a8a11,135005,138265,1,2,3260,16,16
0575f4b6,135005,138625,6,5,3620,16,16
00c03736,135005,138985,6,0,3980,16,16
05e9314b,135005,139345,11,5,4340,16,16
05a0fc9e,135005,139705,14,5,4700,16,16
0899bf16,135005,140065,6,8,5060,16,16
0e2ae3f3,135005,140785,3,14,5780,16,16
0cdaddc2,135005,141145,2,12,6140,16,16
01b69db1,135005,141505,1,1,6500,16,16
03530c72,135005,141865,2,3,6860,16,16
09e05d55,135005,142225,5,9,7220,16,16
058e4fac,135005,142585,12,5,7580,16,16
098d14e4,135005,142945,4,9,7940,16,16
0d0c96bc,135005,143305,12,13,8300,16,16
023cfca3,135005,143665,3,2,8660,16,16
044df289,135005,144025,9,4,9020,16,16
046fae26,135005,144385,6,4,9380,16,16
0bd2358b,135005,144745,11,11,9740,16,16
0aa5649d,135005,145105,13,10,10100,16,16
09197384,135005,145465,4,9,10460,16,16
0fec0d76,135005,145825,6,15,10820,16,16
03a595b2,135005,146185,2,3,11180,16,16
0b8fdf7b,135005,146545,11,11,11540,16,16
0bc35158,337135,337515,8,11,380,16,16
0414ee19,337155,337875,9,4,720,16,16
0f4d362a,337105,338235,10,15,1130,16,16
0869dc1b,337415,338595,11,8,1180,16,16
0129d17e,337175,339325,14,1,2150,16,16
0c627072,337495,339735,2,12,2240,16,16
07bee436,337185,340145,6,7,2960,16,16
0b604868,337285,340515,8,11,3230,16,16
027cb25e,337355,340965,14,2,3610,16,16
05b7b2ce,438095,438725,14,5,630,16,16
058585cf,539295,539945,15,5,650,16,16
03535240,1075,1475,0,3,400,9,4
024d6093,12175,12885,3,2,710,9,4
01056630,23075,23485,0,1,410,9,4
01f998d0,23165,23895,0,1,730,9,4
02284653,34095,34485,0,2,390,9,4
00752120,34155,34845,1,0,690,9,4
00dcd3d0,34425,35205,2,0,780,9,4
013f1763,34365,35565,3,1,1200,9,4
003e3011,34235,36285,1,0,2050,9,4
00df78c2,34575,37005,3,0,2430,9,4
0274a020,135005,135385,0,2,380,9,4
01724c60,135005,135745,0,1,740,9,4
0307ae81,135005,136105,1,3,1100,9,4
03421202,135005,136465,2,3,1460,9,4
0114c3c3,135005,136825,3,1,1820,9,4
03069f23,135005,137185,3,3,2180,9,4
003870a2,135005,137545,2,0,2540,9,4
00fdd6b1,135005,137905,1,0,2900,9,4
02513ae0,337165,337855,0,2,690,9,4
00fdd2a3,337335,338585,3,0,1250,9,4
00241851,337525,338955,1,0,1430,9,4
022554f3,337565,339325,3,2,1760,9,4
0099bf13,438225,438955,3,0,730,9,4
02a4b150,438205,439315,0,2,1110,9,4
03307622,438355,439685,2,3,1330,9,4
025fb4c0,438365,440405,0,2,2040,9,4
03d60b72,539245,539655,2,3,410,9,4
04535240,1075,1615,0,4,540,7,9
0195e812,12035,12415,7,1,380,7,9
014d6090,12045,12845,3,1,800,7,9
01f998d2,12155,13235,6,1,1080,7,9
0197b0d3,12125,13595,7,1,1470,7,9
01284656,12215,14085,6,1,1870,7,9
07752124,23085,23525,4,7,440,7,9
037cd0d1,34065,34465,1,3,400,7,9
053f1766,34155,34825,2,5,670,7,9
07457ed3,34275,35185,3,7,910,7,9
053e3018,34035,35545,4,5,1510,7,9
02dcd3d1,34175,35905,5,2,1730,7,9
03724c63,34495,36995,0,3,2500,7,9
07272777,34705,37355,1,7,2650,7,9
05784c54,34545,37715,2,5,3170,7,9
083870a8,35375,38075,3,8,2700,7,9
03de9f94,34425,38435,4,3,4010,7,9
06b22806,35465,38795,5,6,3330,7,9
0530aca6,36375,39155,6,5,2780,7,9
08e28bd0,35215,39515,7,8,4300,7,9
079650a8,36355,39875,8,7,3520,7,9
0162ad57,36085,40235,0,1,4150,7,9
057d6538,35985,40595,1,5,4610,7,9
04845aa2,35625,40955,2,4,5330,7,9
01c380d7,35895,41315,3,1,5420,7,9
0174a022,36165,41675,4,1,5510,7,9
0363eae3,36185,42035,5,3,5850,7,9
02cdb127,135005,135385,7,2,380,7,9
05488788,135005,135745,8,5,740,7,9
018bdf22,135005,136465,2,1,1460,7,9
03265b67,135005,136825,7,3,1820,7,9
08241855,135005,137185,5,8,2180,7,9
04c4bd90,135005,137545,0,4,2540,7,9
054569f3,135005,137905,3,5,2900,7,9
027fc510,135005,138265,0,2,3260,7,9
06563582,135005,138985,2,6,3980,7,9
07bb4a35,135005,139345,5,7,4340,7,9
04a12893,135005,139705,3,4,4700,7,9
0779a0b3,135005,140065,3,7,5060,7,9
00a4b152,135005,140425,2,0,5420,7,9
04da9f84,135005,140785,4,4,5780,7,9
0233ed07,135005,141145,7,2,6140,7,9
04292b37,337095,337495,7,4,400,7,9
08b36cb6,438205,438655,6,8,450,7,9
0891ae61,438235,439405,1,8,1170,7,9
06fb6658,539395,540235,8,6,840,7,9
01535240,1025,1435,0,1,410,2,2
01284651,34115,34485,0,1,370,2,2
003e3011,34235,34845,1,0,610,2,2
01284651,34115,35205,0,1,1090,2,2
00724c61,34605,35565,1,0,960,2,2
01284651,34115,35925,0,1,1810,2,2
00724c61,34605,36285,1,0,1680,2,2
01284651,34115,36645,0,1,2530,2,2
00724c61,34605,37005,1,0,2400,2,2
01284651,34115,37365,0,1,3250,2,2
00724c61,34605,37725,1,0,3120,2,2
01284651,34115,38085,0,1,3970,2,2
000f3781,135005,135385,1,0,380,2,2
01265b60,337105,337485,0,1,380,2,2
05535241,1015,1495,1,5,480,2,8
0495e815,12085,12525,2,4,440,2,8
044d6096,12175,12975,0,4,800,2,8
02056633,23015,23395,3,2,380,2,8
0197b0d6,34035,34415,4,1,380,2,8
017cd0d3,34275,35495,7,1,1220,2,8
06f998d4,34125,35855,0,6,1730,2,8
003f1762,34355,36215,1,0,1860,2,8
00784c56,34575,36575,2,0,2000,2,8
01724c62,34555,36935,3,1,2380,2,8
07457ed0,34455,37655,5,7,3200,2,8
032d6121,34865,38015,6,3,3150,2,8
05272772,34805,38375,7,5,3570,2,8
02b582d5,35435,39095,1,2,3660,2,8
013d2aa6,34675,39455,2,1,4780,2,8
00ff7e52,34775,39815,3,0,5040,2,8
07457ed0,34455,40185,5,7,5730,2,8
032d6121,34865,40545,6,3,5680,2,8
05272772,34805,40905,7,5,6100,2,8
01fe91d6,135005,135385,6,1,380,2,8
01449233,135005,135745,3,1,740,2,8
0230aca7,135005,136105,7,2,1100,2,8
078bdf25,135005,136465,5,7,1460,2,8
064b3416,135005,136825,6,6,1820,2,8
05c380d6,135005,137185,6,5,2180,2,8
05fdd6b0,135005,137545,0,5,2540,2,8
0074a022,135005,137905,2,0,2900,2,8
02a12893,337105,337575,3,2,470,2,8
07265b62,539015,539405,2,7,390,2,8
09535242,1075,1595,2,9,520,14,12
004d6099,12135,12525,10,0,390,14,12
00f998d6,12255,12955,3,0,700,14,12
0095e816,12045,13315,4,0,1270,14,12
00056630,12195,13705,7,0,1510,14,12
00284655,12305,14065,8,0,1760,14,12
003e3012,12425,14425,9,0,2000,14,12
0075212a,12395,14875,3,0,2480,14,12
0097b0d8,12205,15235,4,0,3030,14,12
077cd0d0,23065,23565,0,7,500,14,12
0a3d2aa0,23565,24135,0,10,570,14,12
032d6120,23715,24705,0,3,990,14,12
00069f26,34095,34525,10,0,430,14,12
09cdb8fa,34045,34885,11,9,840,14,12
08726653,34525,35275,2,8,750,14,12
048495ca,34355,35635,3,4,1280,14,12
0ae28bd7,34455,35995,4,10,1540,14,12
06fdd6b1,35205,36355,5,6,1150,14,12
08f62632,34625,36715,6,8,2090,14,12
06a4ec58,34345,37075,7,6,2730,14,12
0a07ae82,34245,37435,8,10,3190,14,12
023870a0,34715,37825,11,2,3110,14,12
027d6530,35145,38195,1,2,3050,14,12
02b582d8,34465,38915,3,2,4450,14,12
0662ad54,35275,39275,4,6,4000,14,12
0574a02a,35335,40005,7,5,4670,14,12
0212f96b,135005,135385,11,2,380,14,12
00a595bb,135005,135745,11,0,740,14,12
028565f7,135005,136105,7,2,1100,14,12
0740cd01,135005,136465,1,7,1460,14,12
0818779b,135005,136825,11,8,1820,14,12
0771a46b,135005,137185,11,7,2180,14,12
007901c6,135005,137545,6,0,2540,14,12
05737967,135005,137905,7,5,2900,14,12
0a40917b,135005,138265,11,10,3260,14,12
0afe91d8,135005,138625,8,10,3620,14,12
09bf9c6a,135005,138985,10,9,3980,14,12
09307625,135005,139345,5,9,4340,14,12
0792f858,135005,139705,8,7,4700,14,12
029a82f7,135005,140065,7,2,5060,14,12
0b119796,135005,140425,6,11,5420,14,12
08fb9b62,135005,140785,2,8,5780,14,12
0972db66,135005,141145,6,9,6140,14,12
057a6fda,135005,141505,10,5,6500,14,12
088e4fa5,135005,142225,5,8,7220,14,12
082e6ec8,135005,142585,8,8,7580,14,12
0550deb8,135005,142945,8,5,7940,14,12
0699bf1a,135005,143305,10,6,8300,14,12
04ec0d7b,135005,143665,11,4,8660,14,12
08fb52a4,337055,337435,4,8,380,14,12
005ff9e7,337195,337825,7,0,630,14,12
05a1d2aa,337135,338215,10,5,1080,14,12
066c09fb,337025,338575,11,6,1550,14,12
045f48d2,337185,338965,2,4,1780,14,12
0ade6384,337265,339335,4,10,2070,14,12
02345ca0,438245,438785,0,2,540,14,12
0a4e3c81,438195,439145,1,10,950,14,12
08794f24,539545,539975,4,8,430,14,12
0afd3927,539365,540365,7,10,1000,14,12
07df5fa9,539505,540735,9,7,1230,14,12
02535243,1045,1495,3,2,450,7,9
014d6097,12105,12485,2,1,380,7,9
0195e814,12085,12845,3,1,760,7,9
01056637,12185,13205,4,1,1020,7,9
057cd0d4,23365,24035,4,5,670,7,9
043f1768,34095,34545,5,4,450,7,9
07784c50,34385,35275,8,7,890,7,9
07dcd3d2,34145,35635,0,7,1490,7,9
04724c63,34295,36355,2,4,2060,7,9
08de9f97,34255,37075,4,8,2820,7,9
08ff7e53,34485,37435,5,8,2950,7,9
000f3783,36885,37795,6,0,910,7,9
05e28bd5,35095,38515,8,5,3420,7,9
07ccc9d6,35685,39235,1,7,3550,7,9
08b582d3,35195,39595,2,8,4400,7,9
00fe91d3,36205,39955,3,0,3750,7,9
07a12898,36985,40315,4,7,3330,7,9
01c380d4,35905,40675,5,1,4770,7,9
07a4b158,37675,41035,6,7,3360,7,9
0150deb6,37025,41395,7,1,4370,7,9
0274a024,36095,41755,8,2,5660,7,9
074b3412,36815,42115,0,7,5300,7,9
0079a0b0,37285,42475,1,0,5190,7,9
067be713,37305,42835,2,6,5530,7,9
01c380d4,35905,43565,5,1,7660,7,9
038565f6,135005,135385,6,3,380,7,9
082e2ed1,135005,135745,1,8,740,7,9
0240cd02,135005,136105,2,2,1100,7,9
05307621,135005,136465,1,5,1460,7,9
07d945c8,135005,136825,8,7,1820,7,9
0012f968,135005,137185,8,0,2180,7,9
005007e6,135005,137545,6,0,2540,7,9
00a595b2,135005,137905,2,0,2900,7,9
048db5a5,135005,138625,5,4,3620,7,9
02119797,135005,138985,7,2,3980,7,9
08d60b73,135005,139705,3,8,4700,7,9
00ec0d71,135005,140065,1,0,5060,7,9
082ed3d4,135005,140425,4,8,5420,7,9
0692f856,135005,140785,6,6,5780,7,9
08f38863,135005,141145,3,8,6140,7,9
069a82f6,135005,141505,6,6,6500,7,9
00fb9b66,337205,338315,6,0,1110,7,9
061340a4,337165,338785,4,6,1620,7,9
08187794,438065,438465,4,8,400,7,9
04bc4b82,539015,539425,2,4,410,7,9
074bf943,539035,539785,3,7,750,7,9
00535241,1055,1495,1,0,440,3,7
0095e812,12065,12445,5,0,380,3,7
00056631,12175,12835,1,0,660,3,7
004d6092,12085,13225,4,0,1140,3,7
05f998d2,23065,23525,2,5,460,3,7
03284655,34015,34395,2,3,380,3,7
053f1760,34235,34765,4,5,530,3,7
06dcd3d2,34335,35125,5,6,790,3,7
05752124,34045,35485,6,5,1440,3,7
02457ed4,34425,35845,0,2,1420,3,7
023e3010,34145,36205,1,2,2060,3,7
00272775,34825,36565,2,0,1740,3,7
01724c66,34595,36925,3,1,2330,3,7
01ff7e51,34795,37285,4,1,2490,3,7
02784c53,34675,38005,6,2,3330,3,7
052d6121,34835,38365,0,5,3530,3,7
0274a026,36215,38725,1,2,2510,3,7
01ff7e51,34795,39805,4,1,5010,3,7
02784c53,34675,40525,6,2,5850,3,7
052d6121,34835,40885,0,5,6050,3,7
0274a026,36215,41245,1,2,5030,3,7
017be715,135005,135385,5,1,380,3,7
01c603b1,135005,135745,1,1,740,3,7
04307620,135005,136465,0,4,1460,3,7
009a18f5,135005,136825,5,0,1820,3,7
04265b66,135005,137185,6,4,2180,3,7
04502bc6,135005,137545,6,4,2540,3,7
02d945c0,337015,337495,0,2,480,3,7
05bc05b2,337045,337865,2,5,820,3,7
01e37890,337075,338295,0,1,1220,3,7
02ec0d70,539235,539725,0,2,490,3,7
04535241,1095,1485,1,4,390,6,11
0395e817,12065,12445,10,3,380,6,11
0397b0d0,12265,12805,0,3,540,6,11
03f998d7,12295,13175,2,3,880,6,11
03056636,12205,13625,8,3,1420,6,11
034d6099,12155,13985,9,3,1830,6,11
03284650,12395,14395,2,3,2000,6,11
07752124,23025,23545,4,7,520,6,11
0adcd3d4,23275,24095,4,10,820,6,11
03457ed0,34045,34625,8,3,580,6,11
083d2aaa,34345,34985,9,8,640,6,11
03784c52,34285,35345,10,3,1060,6,11
08724c63,34245,35715,1,8,1470,6,11
04df78c5,34145,36075,2,4,1930,6,11
058495c9,35025,36435,3,5,1410,6,11
05272774,34545,36795,4,5,2250,6,11
022d6126,34625,37155,5,2,2530,6,11
05696ce1,34845,37515,6,5,2670,6,11
0a07ae89,34905,37875,7,10,2970,6,11
03a4ec54,34935,38235,8,3,3300,6,11
0303e961,35705,38595,9,3,2890,6,11
07b582d4,35205,38955,10,7,3750,6,11
04f62631,35275,39325,1,4,4050,6,11
09ff7e55,34445,39685,2,9,5240,6,11
05845aa8,35615,40045,3,5,4430,6,11
0163eae4,36055,40405,4,1,4350,6,11
083b8136,35755,41125,6,8,5370,6,11
0374a020,36015,41485,7,3,5470,6,11
02572cf2,36115,41855,9,2,5740,6,11
0962ad57,35965,42215,10,9,6250,6,11
06449234,36135,42585,1,6,6450,6,11
0225a776,135005,135385,6,2,380,6,11
0428f1f2,135005,135745,2,4,740,6,11
042ae3fa,135005,136105,10,4,1100,6,11
03599fa4,135005,136465,4,3,1460,6,11
040f3786,135005,137185,6,4,2180,6,11
07502bc7,135005,137545,7,7,2540,6,11
05c603b1,135005,137905,1,5,2900,6,11
02307628,135005,138265,8,2,3260,6,11
024569f7,135005,138625,7,2,3620,6,11
0aec0d74,135005,138985,4,10,3980,6,11
035816d5,135005,139345,5,3,4340,6,11
02a595b4,135005,139705,4,2,4700,6,11
06a0c8e9,135005,140065,9,6,5060,6,11
049a82f2,135005,140425,2,4,5420,6,11
014b3411,135005,140785,1,1,5780,6,11
0abf9c63,135005,141145,3,10,6140,6,11
08241859,135005,141505,9,8,6500,6,11
02da9f81,135005,142225,1,2,7220,6,11
08e3249a,135005,142585,10,8,7580,6,11
0accec25,135005,142945,5,10,7940,6,11
0190d448,337045,337515,8,1,470,6,11
04b36cb9,337225,337875,9,4,650,6,11
018db5a5,337295,339015,5,1,1720,6,11
0836cda2,438235,438625,2,8,390,6,11
0ae94df4,438405,438995,4,10,590,6,11
04fb6655,438285,439355,5,4,1070,6,11
04ae2b52,438345,439845,2,4,1500,6,11
096adab2,539315,539715,2,9,400,6,11
0753524f,1075,1615,15,7,540,4,16
024d609f,12165,12625,15,2,460,4,16
0295e818,12095,12995,1,2,900,4,16
07056631,23105,23665,1,7,560,4,16
0f97b0da,34075,34465,7,15,390,4,16
053f176b,34395,34825,8,5,430,4,16
0ddcd3d4,34435,35185,9,13,750,4,16
03df78ce,34515,35545,10,3,1030,4,16
013d2aa8,34745,35905,11,1,1160,4,16
0ade9f97,34555,36265,12,10,1710,4,16
05f998dd,34115,36625,13,5,2510,4,16
007cd0d5,34335,36985,14,0,2650,4,16
0b752121,34205,37345,15,11,3140,4,16
0907ae8a,35045,37705,0,9,2660,4,16
0e9650a5,36185,38065,1,14,1880,4,16
06784c5e,34675,38425,2,6,3750,4,16
08272778,34835,38785,3,8,3950,4,16
0d28465c,34125,39145,4,13,5020,4,16
09724c64,34605,39505,5,9,4900,4,16
09c380da,35755,39865,6,9,4110,4,16
0114c3c3,36245,40225,7,1,3980,4,16
0f457edf,34465,40585,8,15,6120,4,16
03069f2d,34995,40945,9,3,5950,4,16
07e28bde,35265,41305,10,7,6040,4,16
02421203,35485,41665,11,2,6180,4,16
0d72665f,35315,42025,12,13,6710,4,16
017d653f,35835,42385,13,1,6550,4,16
01e618a0,36345,42745,14,1,6400,4,16
09513ae9,36825,43115,0,9,6290,4,16
0279a0b5,36955,43845,3,2,6890,4,16
09ccc9dc,35605,44205,4,9,8600,4,16
062554f6,37105,44565,5,6,7460,4,16
0fa1289e,36585,44935,7,15,8350,4,16
0b8bdf2e,36275,45295,8,11,9020,4,16
03b2280d,35405,45655,9,3,10250,4,16
0e449237,36125,46015,10,14,9890,4,16
090f378a,36495,46375,11,9,9880,4,16
0d72665f,35315,46735,12,13,11420,4,16
017d653f,35835,47095,13,1,11260,4,16
0ae37899,135005,135385,9,10,380,4,16
0c7fc519,135005,135745,9,12,740,4,16
007edc8e,135005,136105,14,0,1100,4,16
085007ec,135005,136465,12,8,1460,4,16
0bbf6d33,135005,136825,3,11,1820,4,16
0fb4b49c,135005,137185,12,15,2180,4,16
0af38863,135005,137545,3,10,2540,4,16
05dbc26c,135005,137905,12,5,2900,4,16
0c292b39,135005,138265,9,12,3260,4,16
01b36cb9,135005,138625,9,1,3620,4,16
042e2ed2,135005,138985,2,4,3980,4,16
09e94df8,135005,139345,8,9,4340,4,16
0d90b2a3,135005,139705,3,13,4700,4,16
08a4b15c,135005,140065,12,8,5060,4,16
00d60b7a,135005,140785,10,0,5780,4,16
0aebc9a7,337025,337495,7,10,470,4,16
02f72fd3,337125,338065,3,2,940,4,16
0feed56b,539205,539785,11,15,580,4,16
0c9e94ee,539215,540175,14,12,960,4,16
0c53524a,1025,1455,10,12,430,10,15
034d6094,12055,12485,11,3,430,10,15
03f998d9,12235,12915,1,3,680,10,15
0305663c,12075,13305,4,3,1230,10,15
0395e811,12045,13665,5,3,1620,10,15
0375212b,12355,14035,7,3,1680,10,15
03284656,12325,14605,4,3,2280,10,15
033e301d,12435,14965,5,3,2530,10,15
047cd0d2,23085,23605,2,4,520,10,15
07df78c2,23365,24235,2,7,870,10,15
0dde9f9b,34045,34465,10,13,420,10,15
052d612a,34225,34825,11,5,600,10,15
05069f21,34405,35545,13,5,1140,10,15
043d2aa4,34085,35905,14,4,1820,10,15
01724c69,34055,36265,0,1,2210,10,15
09cdb8fd,34325,36625,1,9,2300,10,15
0e572cfb,35695,36985,2,14,1290,10,15
01a4ec54,34585,37345,3,1,2760,10,15
0163eae0,35545,37705,4,1,2160,10,15
0bb2280b,34905,38065,5,11,3160,10,15
043870a9,34885,38425,6,4,3540,10,15
01ff7e56,34125,38785,7,1,4660,10,15
01784c52,34075,39145,8,1,5070,10,15
0c449233,35765,39505,9,12,3740,10,15
0e42120c,34995,39875,11,14,4880,10,15
079650ad,35805,40235,12,7,4430,10,15
0eccc9dc,35105,40595,13,14,5490,10,15
0374a025,35525,40955,14,3,5430,10,15
088bdf25,35955,41315,0,8,5360,10,15
02a12895,36255,41675,1,2,5420,10,15
012554f4,36795,42045,3,1,5250,10,15
0a4b3419,36085,42405,4,10,6320,10,15
08241855,36755,42765,5,8,6010,10,15
0cfdd2a9,36655,43135,7,12,6480,10,15
0a502bc1,36565,43495,8,10,6930,10,15
047be713,36705,44245,12,4,7540,10,15
0efe91d9,35645,44605,13,14,8960,10,15
0d513ae5,36495,44975,0,13,8480,10,15
0c1ff448,135005,135385,8,12,380,10,15
029e94e2,135005,135745,2,2,740,10,15
057ca590,135005,136105,0,5,1100,10,15
0e49b043,135005,136465,3,14,1460,10,15
0e1451c6,135005,136825,6,14,1820,10,15
03199bab,135005,137185,11,3,2180,10,15
0761ab67,135005,137545,7,7,2540,10,15
08cee610,135005,137905,0,8,2900,10,15
0d1b498d,135005,138265,13,13,3260,10,15
086333ae,135005,138625,14,8,3620,10,15
05d60b75,135005,138985,5,5,3980,10,15
0ad7f0ca,135005,139345,10,10,4340,10,15
0cbf6d36,135005,139705,6,12,4700,10,15
03ff29ce,135005,140065,14,3,5060,10,15
0cb36cbb,135005,140425,11,12,5420,10,15
0c102c30,135005,140785,0,12,5780,10,15
0165d93b,135005,141145,11,1,6140,10,15
0237195e,135005,141505,14,2,6500,10,15
0dc9c2e0,135005,141865,0,13,6860,10,15
065c4702,135005,142225,2,6,7220,10,15
0e921c0e,135005,142585,14,14,7580,10,15
07d2b792,135005,142945,2,7,7940,10,15
0e175c17,135005,143305,7,14,8300,10,15
07a8ca1a,135005,143665,10,7,8660,10,15
019a18fd,135005,144025,13,1,9020,10,15
007fc513,135005,144385,3,0,9380,10,15
049e739b,135005,144745,11,4,9740,10,15
07f38861,135005,145105,1,7,10100,10,15
0d90d445,135005,145465,5,13,10460,10,15
06e94dfc,135005,145825,12,6,10820,10,15
0d5f48d7,337085,337495,7,13,410,10,15
07fa879b,337235,337905,11,7,670,10,15
015ff9ee,337125,338295,14,1,1170,10,15
09de6382,337165,338685,2,9,1520,10,15
06345cab,337335,339195,11,6,1860,10,15
0df4113c,438045,438635,12,13,590,10,15
05b3b7f7,539295,539815,7,5,520,10,15
0a39086c,539325,540245,12,10,920,10,15
0c95e81b,12065,12505,1,12,440,3,14
044d6098,23065,23645,8,4,580,3,14
0197b0d8,23155,24255,8,1,1100,3,14
08f998db,34025,34485,0,8,460,3,14
08457ed4,34395,35245,5,8,850,3,14
093d2aa9,34805,35605,6,9,800,3,14
033f1768,34255,35965,7,3,1710,3,14
06726657,35395,36325,8,6,930,3,14
02dcd3db,34335,36685,9,2,2350,3,14
07272776,34875,37045,10,7,2170,3,14
0175212c,34075,37405,11,1,3330,3,14
087cd0d2,34175,37765,12,8,3590,3,14
063e3015,34155,38125,13,6,3970,3,14
0bf62632,35445,38485,0,11,3040,3,14
0db2280a,35585,38845,1,13,3260,3,14
0807ae87,35065,39205,2,8,4140,3,14
01724c6c,34665,39565,3,1,4900,3,14
01784c50,34705,39935,5,1,5230,3,14
073870a8,35525,40295,6,7,4770,3,14
02de9f98,34565,40655,7,2,6090,3,14
082d6125,34895,41025,9,8,6130,3,14
05069f24,34985,41385,10,5,6400,3,14
02421204,35605,41755,12,2,6150,3,14
08845aaa,35655,42115,13,8,6460,3,14
0de28bd5,35345,42525,3,13,7180,3,14
03ccc9d1,35675,42895,5,3,7220,3,14
086333a5,135005,135745,5,8,740,3,14
0999bf14,135005,136105,4,9,1100,3,14
0d5fb4c5,135005,136465,5,13,1460,3,14
04da9f8a,135005,136825,10,4,1820,3,14
093b8135,135005,137185,5,9,2180,3,14
0afdd6bd,135005,137545,13,10,2540,3,14
0163eae3,135005,137905,3,1,2900,3,14
00449236,135005,138265,6,0,3260,3,14
0014c3cb,135005,138625,11,0,3620,3,14
03a12893,135005,139345,3,3,4340,3,14
0cbf9c67,135005,139705,7,12,4700,3,14
09fdd2a2,135005,140065,2,9,5060,3,14
0be3789c,337045,337935,12,11,890,3,14
00bc05b1,337025,338325,1,0,1300,3,14
04ec0d77,438105,438515,7,4,410,3,14
0833ed0c,438025,438945,12,8,920,3,14
0112f96c,539135,539735,12,1,600,3,14
02535241,1005,1395,1,2,390,3,3
0195e812,12045,12445,0,1,400,3,3
014d6091,12115,12815,2,1,700,3,3
01056630,12205,13175,0,1,970,3,3
0097b0d1,23045,23465,1,0,420,3,3
00284651,34085,34485,2,0,400,3,3
003e3012,34155,35205,1,0,1050,3,3
00dcd3d1,34335,35565,2,0,1230,3,3
02de9f92,34485,35925,0,2,1440,3,3
02457ed2,34435,36285,1,2,1850,3,3
00dcd3d1,34335,36645,2,0,2310,3,3
02de9f92,34485,37005,0,2,2520,3,3
02457ed2,34435,37365,1,2,2930,3,3
00dcd3d1,34335,37725,2,0,3390,3,3
02de9f92,34485,38085,0,2,3600,3,3
02457ed2,34435,38445,1,2,4010,3,3
0050deb2,135005,135745,2,0,740,3,3
00513ae1,135005,136105,1,0,1100,3,3
00241851,337025,337435,1,0,410,3,3
022554f1,337075,337825,1,2,750,3,3
013327e0,539145,539565,0,1,420,3,3
05535248,1075,1555,8,5,480,15,13
0795e814,12045,12525,6,7,480,15,13
0797b0d3,12215,13275,10,7,1060,15,13
07f998d4,12245,13645,12,7,1400,15,13
07752129,12355,14055,3,7,1700,15,13
0728465b,12325,14525,10,7,2200,15,13
063e301a,23045,23605,10,6,560,15,13
077cd0d7,34065,34465,3,7,400,15,13
003f1763,34155,34895,8,0,740,15,13
03de9f92,34425,35265,10,3,840,15,13
00b582d2,35115,35625,11,0,510,15,13
0acdb8f6,34825,35985,12,10,1160,15,13
07457edc,34265,36345,0,7,2080,15,13
0bdcd3d7,34245,36705,1,11,2460,15,13
0cdf78c4,34325,37065,2,12,2740,15,13
00784c5a,34575,37455,5,0,2880,15,13
082d6128,34775,37815,6,8,3040,15,13
01724c65,34525,38175,7,1,3650,15,13
0207ae86,35015,38535,8,2,3520,15,13
048495c4,35085,38895,9,4,3810,15,13
0be28bd3,35105,39255,10,11,4150,15,13
01ff7e56,34685,39645,0,1,4960,15,13
0c726650,35155,40005,1,12,4850,15,13
06a4ec5a,35075,40415,5,6,5340,15,13
013870ab,35275,40775,6,1,5500,15,13
01069f2b,34895,41135,7,1,6240,15,13
06f6263a,35175,41505,9,6,6330,15,13
07b80a82,135005,135385,2,7,380,15,13
07421205,135005,135745,5,7,740,15,13
0030aca1,135005,136105,1,0,1100,15,13
017be712,135005,136465,2,1,1460,15,13
044569f1,135005,136825,1,4,1820,15,13
085007e8,135005,137185,8,8,2180,15,13
02599fa0,135005,137545,0,2,2540,15,13
05fb665b,135005,137905,11,5,2900,15,13
047a6fdb,135005,138985,11,4,3980,15,13
03761375,135005,139345,5,3,4340,15,13
06409177,135005,139705,7,6,4700,15,13
00345ca0,135005,140065,0,0,5060,15,13
05449231,135005,140425,1,5,5420,15,13
08fdd2ac,135005,140785,12,8,5780,15,13
01da9f85,135005,141145,5,1,6140,15,13
072ed3d1,135005,141505,1,7,6500,15,13
07a0c8ea,135005,141865,10,7,6860,15,13
012e2ed4,135005,142225,4,1,7220,15,13
02eed565,135005,142585,5,2,7580,15,13
094266d3,135005,142945,3,9,7940,15,13
0b7e4086,135005,143305,6,11,8300,15,13
044f61a9,135005,143665,9,4,8660,15,13
098e4fa5,135005,144025,5,9,9020,15,13
060168a3,135005,144385,3,6,9380,15,13
0b390863,337045,337425,3,11,380,15,13
08794f27,337165,337835,7,8,670,15,13
023cfca9,337405,338205,9,2,800,15,13
03879a9a,337435,338565,10,3,1130,15,13
07521321,337195,339655,1,7,2460,15,13
07df5fa2,337105,340015,2,7,2910,15,13
07e5ebd3,337255,340375,3,7,3120,15,13
075a8a14,337445,340735,4,7,3290,15,13
0a51e0b6,337585,341105,6,10,3520,15,13
019a4e42,337385,341615,2,1,4230,15,13
03148754,438205,438765,4,3,560,15,13
073819b5,438465,439125,5,7,660,15,13
0483dc97,438125,439495,7,4,1370,15,13
0a4e02d9,438715,439865,9,10,1150,15,13
075e788a,438335,440225,10,7,1890,15,13
019b0c2b,438805,440585,11,1,1780,15,13
04e45922,438555,440995,2,4,2440,15,13
0bfb4ae7,438425,441425,7,11,3000,15,13
0375f4b2,438755,441915,2,3,3160,15,13
063050d9,539115,539585,9,6,470,15,13
043e2043,539665,540075,3,4,410,15,13
0696256c,539525,540915,12,6,1390,15,13
00535241,1025,1455,1,0,430,4,3
014d6092,12145,12825,2,1,680,4,3
01056630,12225,13215,2,1,990,4,3
023e3012,34335,34855,1,2,520,4,3
00752122,34235,35215,2,0,980,4,3
02dcd3d0,34545,35575,0,2,1030,4,3
02de9f90,34725,35935,1,2,1210,4,3
01457ed2,34605,36295,2,1,1690,4,3
02784c52,34875,36655,0,2,1780,4,3
02de9f90,34725,37015,1,2,2290,4,3
01457ed2,34605,37375,2,1,2770,4,3
02784c52,34875,37735,0,2,2860,4,3
02de9f90,34725,38095,1,2,3370,4,3
01457ed2,34605,38455,2,1,3850,4,3
02784c52,34875,38815,0,2,3940,4,3
02de9f90,34725,39175,1,2,4450,4,3
0099bf10,135005,135745,0,0,740,4,3
011559f2,135005,136105,2,1,1100,4,3
024569f0,337095,337475,0,2,380,4,3
02e37890,337195,337865,0,2,670,4,3
02e32490,438105,438525,0,2,420,4,3
017fc512,438215,439245,2,1,1030,4,3
00ccec22,539135,539535,2,0,400,4,3
09535243,1035,1615,3,9,580,10,12
0195e812,12035,12565,0,1,530,10,12
014d6090,23085,23565,0,1,480,10,12
0a457ed9,34135,34515,9,10,380,10,12
08dcd3d6,34085,34875,10,8,790,10,12
09724c6b,34265,35235,11,9,970,10,12
0ade9f92,34255,35595,0,10,1340,10,12
0b3f176b,34055,35955,1,11,1900,10,12
07272776,34535,36315,2,7,1780,10,12
09ff7e51,34465,36675,3,9,2210,10,12
012d612b,34565,37035,4,1,2470,10,12
0bcdb8fa,34655,37395,5,11,2740,10,12
02df78c4,34195,37755,6,2,3560,10,12
058495c4,34935,38115,7,5,3180,10,12
03784c52,34365,38475,8,3,4110,10,12
01e28bd6,35015,38885,0,1,3870,10,12
00b582d2,35055,39245,1,0,4190,10,12
0a069f23,34735,39655,5,10,4920,10,12
0407ae81,34835,40015,6,4,5180,10,12
09726655,35065,40385,8,9,5320,10,12
09fdd2a7,135005,135385,7,9,380,10,12
06c4bd94,135005,135745,4,6,740,10,12
09e37894,135005,136105,4,9,1100,10,12
012ed3db,135005,136465,11,1,1460,10,12
09b4b493,135005,136825,3,9,1820,10,12
02bb4a3a,135005,137185,10,2,2180,10,12
032e2ed2,135005,137545,2,3,2540,10,12
06e8a380,135005,138265,0,6,3260,10,12
0662ad56,135005,138985,6,6,3980,10,12
01e618a2,135005,139345,2,1,4340,10,12
02d945c6,135005,140065,6,2,5060,10,12
097edc8a,135005,140425,10,9,5420,10,12
01488785,135005,140785,5,1,5780,10,12
09dbc262,135005,141145,2,9,6140,10,12
038db5a9,135005,141505,9,3,6500,10,12
0490b2a9,135005,141865,9,4,6860,10,12
081340a3,135005,142225,3,8,7220,10,12
05cde4d7,135005,142585,7,5,7580,10,12
017d6531,135005,142945,1,1,7940,10,12
0314c3c7,135005,143305,7,3,8300,10,12
00513ae8,135005,143665,8,0,8660,10,12
08ebab45,337065,337455,5,8,390,10,12
0218d88b,337095,337905,11,2,810,10,12
060042d0,337225,338265,0,6,1040,10,12
04530c75,337255,338695,5,4,1440,10,12
05cd928b,337155,339145,11,5,1990,10,12
037901ca,438415,438805,10,3,390,10,12
047a6fdb,438255,439165,11,4,910,10,12
0b408da3,438515,439575,3,11,1060,10,12
03567864,438495,439935,4,3,1440,10,12
00e0729b,438355,440405,11,0,2050,10,12
04e05d52,539435,539825,2,4,390,10,12
09535240,1035,1555,0,9,520,10,12
0a95e813,12025,12445,6,10,420,10,12
0a284651,12285,12835,9,10,550,10,12
0af998d4,12225,13245,1,10,1020,10,12
0a97b0d1,12205,13605,2,10,1400,10,12
0a4d6099,12045,13965,3,10,1920,10,12
0a056631,12115,14325,4,10,2210,10,12
0a752125,12335,14685,5,10,2350,10,12
0a3e3011,12435,15055,7,10,2620,10,12
0a7cd0d6,12515,15585,5,10,3070,10,12
073f1769,23045,23505,9,7,460,10,12
02724c69,23445,24075,9,2,630,10,12
06784c5b,34065,34565,0,6,500,10,12
07cdb8f0,34455,34935,2,7,480,10,12
033d2aa5,34155,35305,4,3,1150,10,12
02272771,34335,35715,8,2,1380,10,12
042d6125,34435,36085,10,4,1650,10,12
06069f22,34505,36805,0,6,2300,10,12
070f3782,135005,135385,2,7,380,10,12
00241852,135005,135745,2,0,740,10,12
091559f0,135005,136105,0,9,1100,10,12
05ec0d79,135005,136465,9,5,1460,10,12
055816d0,135005,136825,0,5,1820,10,12
0a8565f2,135005,137545,2,10,2540,10,12
00ae2b57,135005,137905,7,0,2900,10,12
0af72fd1,135005,138265,1,10,3260,10,12
0b07ae88,135005,138625,8,11,3620,10,12
08845aa6,135005,138985,6,8,3980,10,12
00fe91da,135005,139345,10,0,4340,10,12
0879a0ba,135005,139705,10,8,4700,10,12
0a307623,135005,140065,3,10,5060,10,12
03e3249a,135005,140425,10,3,5420,10,12
08cdb123,135005,140785,3,8,5780,10,12
0b2ae3f4,135005,141145,4,11,6140,10,12
099a82fb,135005,141505,11,9,6500,10,12
0036cda2,135005,141865,2,0,6860,10,12
05daddc0,135005,142225,0,5,7220,10,12
07187798,135005,142585,8,7,7580,10,12
03b22800,135005,142945,0,3,7940,10,12
0574a024,135005,143305,4,5,8300,10,12
064b3415,135005,143665,5,6,8660,10,12
004266d9,337045,337535,9,0,490,10,12
05b49caa,337155,337895,10,5,740,10,12
09371950,337215,338265,0,9,1050,10,12
025e2761,337075,338625,1,2,1550,10,12
0971a466,337235,339055,6,9,1820,10,12
0a72db67,337195,339415,7,10,2220,10,12
02261f74,539165,540265,4,2,1100,10,12
03cd9280,539435,540755,0,3,1320,10,12
02535243,1085,1535,3,2,450,15,4
0295e810,12035,12415,0,2,380,15,4
02056631,12075,13145,3,2,1070,15,4
02f998d2,12205,13555,3,2,1350,15,4
01dcd3d3,23245,23875,3,1,630,15,4
02457ed3,34045,34425,1,2,380,15,4
00784c50,34385,34785,2,0,400,15,4
02724c61,34335,35565,0,2,1230,15,4
017be713,135005,135385,3,1,380,15,4
0130aca2,135005,136465,2,1,1460,15,4
00da9f82,135005,136825,2,0,1820,15,4
033870a2,135005,137185,2,3,2180,15,4
022ed3d3,337015,337415,3,2,400,15,4
015007e2,337165,338145,2,1,980,15,4
00a595b3,337695,338505,3,0,810,15,4
02488780,337605,338865,0,2,1260,15,4
0292f851,337555,339225,1,2,1670,15,4
01563583,438185,438615,3,1,430,15,4
01ff29c0,438315,438975,0,1,660,15,4
00a0c8e1,438215,439335,1,0,1120,15,4
01617732,438465,440445,2,1,1980,15,4
029a82f1,539115,539505,1,2,390,15,4
03bb4a32,539105,539865,2,3,760,15,4
002e2ed3,539575,540335,3,0,760,15,4
04535243,1085,1535,3,4,450,8,7
0195e813,12075,12565,4,1,490,8,7
054d6094,23035,23425,4,5,390,8,7
05f998d4,23155,23895,4,5,740,8,7
02284655,34055,34465,6,2,410,8,7
06dcd3d0,34415,34825,0,6,410,8,7
063e3016,34195,35195,2,6,1000,8,7
00457ed6,34505,35915,4,0,1410,8,7
06de9f90,34655,36275,5,6,1620,8,7
05784c52,34765,36635,6,5,1870,8,7
02696ce3,35125,36995,0,2,1870,8,7
03cdb8f5,35045,37355,1,3,2310,8,7
0007ae80,35155,37715,2,0,2560,8,7
00e28bd4,35305,38075,3,0,2770,8,7
06c380d5,35895,38435,4,6,2540,8,7
023870a3,35475,38795,5,2,3320,8,7
05e618a5,36735,39515,0,5,2780,8,7
060f3782,36945,39875,1,6,2930,8,7
00a12890,36975,40235,2,0,3260,8,7
00e28bd4,35305,40595,3,0,5290,8,7
017be711,37515,41315,5,1,3800,8,7
01265b64,37095,42035,0,1,4940,8,7
032554f0,37655,42395,1,3,4740,8,7
01ec0d70,135005,135385,0,1,380,8,7
02cdb122,135005,135745,2,2,740,8,7
01599fa0,135005,136465,0,1,1460,8,7
043327e3,135005,137185,3,4,2180,8,7
02da9f83,135005,137545,3,2,2540,8,7
0525a770,135005,137905,0,5,2900,8,7
0292f854,135005,138265,4,2,3260,8,7
06a0c8e0,135005,138625,0,6,3620,8,7
018565f2,135005,138985,2,1,3980,8,7
061559f6,135005,139705,6,6,4700,8,7
02e32494,135005,140065,4,2,5060,8,7
0240cd04,337035,337435,4,2,400,8,7
011ff446,337025,337805,6,1,780,8,7
006adab2,337075,338195,2,0,1120,8,7
02ebc9a6,337215,338945,6,2,1730,8,7
04daddc2,337185,339335,2,4,2150,8,7
01f72fd0,438035,438525,0,1,490,8,7
0853524b,1005,1475,11,8,470,1,15
0e95e815,12015,12585,1,14,570,1,15
0e4d609c,23075,23505,12,14,430,1,15
0505663a,34105,34625,3,5,520,1,15
063e301e,34445,34995,5,6,550,1,15
0e97b0db,34185,35355,6,14,1170,1,15
04752124,34425,35715,7,4,1290,1,15
0b27277a,35165,36075,8,11,910,1,15
077cd0d8,34495,36435,9,7,1940,1,15
06f998db,34285,36795,10,6,2510,1,15
02df78c3,34725,37515,12,2,2790,1,15
022d612e,35195,37875,13,2,2680,1,15
07ff7e54,35095,38235,14,7,3140,1,15
01724c61,34905,38595,0,1,3690,1,15
07de9f96,34805,38955,1,7,4150,1,15
073f1764,34575,39315,2,7,4740,1,15
0505663a,34105,39675,3,5,5570,1,15
0e97b0db,34185,40065,6,14,5880,1,15
04752124,34425,40425,7,4,6000,1,15
077cd0d8,34495,40795,9,7,6300,1,15
06f998db,34285,41155,10,6,6870,1,15
022d612e,35195,41885,13,2,6690,1,15
01724c61,34905,42255,0,1,7350,1,15
07de9f96,34805,42615,1,7,7810,1,15
073f1764,34575,42975,2,7,8400,1,15
03fdd6b8,135005,135385,8,3,380,1,15
0962ad5a,135005,135745,10,9,740,1,15
0c74a027,135005,136105,7,12,1100,1,15
0863eae1,135005,136465,1,8,1460,1,15
0cfe91de,135005,136825,14,12,1820,1,15
07572cf7,135005,137185,7,7,2180,1,15
0744923d,135005,137545,13,7,2540,1,15
049650ac,135005,137905,12,4,2900,1,15
0530acaa,135005,138265,10,5,3260,1,15
0a845aa6,135005,138625,6,10,3620,1,15
0accc9d1,135005,138985,1,10,3980,1,15
0003e96e,135005,139345,14,0,4340,1,15
043b8134,135005,139705,4,4,4700,1,15
0dc380dd,135005,140065,13,13,5060,1,15
0e7d6530,135005,140425,0,14,5420,1,15
048bdf2a,337085,337555,10,4,470,1,15
03e618aa,539035,539585,10,3,550,1,15
00535246,1025,1475,6,0,450,16,10
02056631,12115,12775,4,2,660,16,10
02f998d1,12265,13135,5,2,870,16,10
024d6090,12065,13505,7,2,1440,16,10
0297b0d1,12205,13915,1,2,1710,16,10
07284651,23045,23585,1,7,540,16,10
07784c51,23595,24115,1,7,520,16,10
09272771,23795,24645,1,9,850,16,10
002d6122,34075,34945,2,0,870,16,10
05696ce2,34245,35305,3,5,1060,16,10
07a4ec56,34355,35675,5,7,1320,16,10
0407ae84,34345,36035,6,4,1690,16,10
01069f23,34175,36405,8,1,2230,16,10
04b582d3,34485,36765,9,4,2280,16,10
098495c3,34375,37125,0,9,2750,16,10
02e28bd8,34455,37515,3,2,3060,16,10
03449230,135005,135385,0,3,380,16,10
0979a0b0,135005,135745,0,9,740,16,10
074569f6,135005,136105,6,7,1100,16,10
025816d6,135005,136465,6,2,1460,16,10
05119798,135005,137185,8,5,2180,16,10
06187791,135005,137545,1,6,2540,16,10
03ea7669,135005,138265,9,3,3260,16,10
01f62636,135005,138625,6,1,3620,16,10
08502bc7,135005,138985,7,8,3980,16,10
00da9f82,135005,139345,2,0,4340,16,10
07cdb129,135005,139705,9,7,4700,16,10
00599fa7,135005,140065,7,0,5060,16,10
07ae2b58,135005,140425,8,7,5420,16,10
05fb9b65,135005,140785,5,5,5780,16,10
0971a464,135005,141145,4,9,6140,16,10
07408da4,135005,141505,4,7,6500,16,10
079837d1,135005,141865,1,7,6860,16,10
05fe91d7,135005,142225,7,5,7220,16,10
07396501,337095,337575,1,7,480,16,10
00c59f52,337155,337935,2,0,780,16,10
07b80a83,337795,338295,3,7,500,16,10
012e6ec4,337525,338655,4,1,1130,16,10
04a8a295,337255,339015,5,4,1760,16,10
01c42737,337485,339385,7,1,1900,16,10
04574c58,337365,339745,8,4,2380,16,10
03175c10,337305,340115,0,3,2810,16,10
07488351,337195,340475,1,7,3280,16,10
071b4982,337375,340835,2,7,3460,16,10
050168a4,337615,341205,4,5,3590,16,10
09efda97,337825,341595,7,9,3770,16,10
0227b4b8,337435,341955,8,2,4520,16,10
028d14e1,337695,342345,1,2,4650,16,10
03a1d2a5,438245,438655,5,3,410,16,10
006c09f7,438195,439025,7,0,830,16,10
07fb52a8,438205,439385,8,7,1180,16,10
075f48d0,438345,439755,0,7,1410,16,10
06de6382,438415,440125,2,6,1710,16,10
06fa8797,438505,440555,7,6,2050,16,10
034e3c82,539055,539605,2,3,550,16,10
04fd3928,539595,540615,8,4,1020,16,10
08b3b7f9,539755,540975,9,8,1220,16,10
01535243,1045,1455,3,1,410,11,4
0295e812,12025,12405,0,2,380,11,4
02284652,12375,12765,1,2,390,11,4
024d6093,12115,13135,3,2,1020,11,4
02f998d0,12345,13495,0,2,1150,11,4
02056630,12205,13885,3,2,1680,11,4
013e3013,23095,23475,3,1,380,11,4
03de9f92,34045,34425,1,3,380,11,4
03069f23,34575,36225,2,3,1650,11,4
01421201,35145,36585,3,1,1440,11,4
037d6530,35515,36945,0,3,1430,11,4
0274a021,35705,37305,1,2,1600,11,4
00449233,35975,37665,2,0,1690,11,4
00b34d81,36385,38025,3,0,1640,11,4
0274a021,35705,38745,1,2,3040,11,4
01bf9c62,36725,39105,2,1,2380,11,4
003327e1,37345,39465,3,0,2120,11,4
02563582,135005,135385,2,2,380,11,4
01c4bd90,135005,135745,0,1,740,11,4
035007e2,135005,136465,2,3,1460,11,4
02292b30,135005,136825,0,2,1820,11,4
01bc05b0,135005,137185,0,1,2180,11,4
002ae3f3,135005,137905,3,0,2900,11,4
028fdf73,337025,337415,3,2,390,11,4
0191ae62,337155,338145,2,1,990,11,4
0040cd01,438525,439105,1,0,580,11,4
01119793,438365,439825,3,1,1460,11,4
031ff440,438445,440185,0,3,1740,11,4
026adab1,438615,440545,1,2,1930,11,4
09535247,1065,1455,7,9,390,10,12
014d6096,12085,12485,8,1,400,10,12
01752129,12475,12895,0,1,420,10,12
0195e811,12045,13285,3,1,1240,10,12
01f998d5,12315,13645,4,1,1330,10,12
01056636,12155,14035,7,1,1880,10,12
013e3014,12525,14425,10,1,1900,10,12
01284655,12415,14855,3,1,2440,10,12
0197b0d2,12215,15265,7,1,3050,10,12
047cd0d8,23055,23485,8,4,430,10,12
023d2aa8,23465,24055,8,2,590,10,12
05ff7e56,34025,34465,7,5,440,10,12
02272774,34105,34825,8,2,720,10,12
03696ceb,34405,35185,9,3,780,10,12
0342120b,35005,35545,10,3,540,10,12
0307ae8b,34495,35905,11,3,1410,10,12
038495c8,34605,36265,0,3,1660,10,12
02cdb8f7,34245,36625,1,2,2380,10,12
08b22801,34935,36985,2,8,2050,10,12
01e618a9,35965,37345,3,1,1380,10,12
082d6124,34205,37705,4,8,3500,10,12
02e28bd4,34695,38065,5,2,3370,10,12
07ccc9d7,35085,38425,6,7,3340,10,12
04449232,35665,38785,7,4,3120,10,12
03726658,34785,39145,8,3,4360,10,12
05845aa1,35075,39505,9,5,4430,10,12
0462ad59,35405,39865,10,4,4460,10,12
0a4b3418,36025,40225,11,10,4200,10,12
08a12896,36225,40585,0,8,4360,10,12
0a30aca2,35785,40945,1,10,5160,10,12
03a4b15a,36955,41305,2,3,4350,10,12
08307627,37175,41675,4,8,4500,10,12
08241852,36755,42035,5,8,5280,10,12
059650ab,35705,42395,6,5,6690,10,12
0b1559f8,37265,42755,7,11,5490,10,12
0450deb6,36275,43115,8,4,6840,10,12
0299bf11,37055,43475,9,2,6420,10,12
06502bc0,36475,43835,10,6,7360,10,12
05c603ba,36845,44195,11,5,7350,10,12
086333a4,36915,44555,0,8,7640,10,12
09da9f86,37405,44915,1,9,7510,10,12
095fb4c0,37205,45275,2,9,8070,10,12
0a599fa8,135005,135385,8,10,380,10,12
0191ae6b,135005,135745,11,1,740,10,12
0140cd08,135005,136105,8,1,1100,10,12
0497667a,135005,136465,10,4,1460,10,12
04b69db4,135005,136825,4,4,1820,10,12
09261f76,135005,137185,6,9,2180,10,12
0a7a6fd9,135005,137545,9,10,2540,10,12
06ab35eb,135005,137905,11,6,2900,10,12
079837d4,135005,138265,4,7,3260,10,12
014569f8,135005,138625,8,1,3620,10,12
08ccec26,135005,138985,6,8,3980,10,12
0692f858,135005,139345,8,6,4340,10,12
008fdf73,135005,139705,3,0,4700,10,12
0b119793,135005,140065,3,11,5060,10,12
07eed56a,135005,140425,10,7,5420,10,12
0af2c04a,135005,140785,10,10,5780,10,12
0a7e4081,135005,141505,1,10,6500,10,12
0a50473b,135005,141865,11,10,6860,10,12
0759f26a,135005,142225,10,7,7220,10,12
068e4faa,135005,142585,10,6,7580,10,12
0912f962,135005,142945,2,9,7940,10,12
0828f1f2,135005,143305,2,8,8300,10,12
09a0c8e8,135005,143665,8,9,8660,10,12
01c59f50,337135,337595,0,1,460,10,12
02574c51,337315,337955,1,2,640,10,12
0327b4b2,337355,338315,2,3,960,10,12
02396503,337065,338675,3,2,1610,10,12
05488356,337155,339065,6,5,1910,10,12
06175c13,337255,340235,3,6,2980,10,12
012e6ec8,337485,340665,8,1,3180,10,12
0a1b498b,337335,341055,11,10,3720,10,12
058d14e2,438085,438495,2,5,410,10,12
01a8ca13,438195,438855,3,1,660,10,12
01bb90e4,438225,439215,4,1,990,10,12
05efda96,438135,439585,6,5,1450,10,12
05b80a80,438095,440035,0,5,1940,10,12
074e3c84,539435,539865,4,7,430,10,12
055ff9e0,539285,540355,0,5,1070,10,12
09535244,1015,1405,4,9,390,16,12
00056632,12115,12505,9,0,390,16,12
00284651,12275,12865,10,0,590,16,12
0097b0d3,12165,13225,11,0,1060,16,12
004d6095,12055,13595,1,0,1540,16,12
0095e817,12045,13965,3,0,1920,16,12
00f998d4,12235,14375,7,0,2140,16,12
04752127,23015,23465,7,4,450,16,12
043d2aa7,23385,24035,7,4,650,16,12
08cdb8f7,23665,24605,7,8,940,16,12
06069f29,34085,34485,8,6,400,16,12
0607ae80,34195,34845,9,6,650,16,12
0742120a,34735,35205,10,7,470,16,12
04845aa2,34815,35565,11,4,750,16,12
02c380d3,35085,35925,0,2,840,16,12
058bdf26,35895,36285,1,5,390,16,12
03a4ec53,34245,36645,2,3,2400,16,12
048495c0,34335,37005,3,4,2670,16,12
08f62632,34595,37365,4,8,2770,16,12
0b7d653a,35135,37725,5,11,2590,16,12
08e28bd1,34425,38085,6,8,3660,16,12
06696ce3,34165,38445,7,6,4280,16,12
013870a7,34605,38805,8,1,4200,16,12
08fe91d0,35515,39165,9,8,3650,16,12
03fdd6b0,35195,39885,11,3,4690,16,12
05b582d2,34465,40615,2,5,6150,16,12
04b34d82,36045,40975,3,4,4930,16,12
0663eae6,35435,41335,4,6,5900,16,12
0830aca9,35755,41695,5,8,5940,16,12
0444923b,35625,42055,6,4,6430,16,12
02726659,34525,42415,7,2,7890,16,12
0014c3c5,35795,42775,8,0,6980,16,12
04e618ab,35955,43505,11,4,7550,16,12
04caf2a3,135005,135385,3,4,380,16,12
058db5a2,135005,135745,2,5,740,16,12
01102c36,135005,136105,6,1,1100,16,12
014266d7,135005,136465,7,1,1460,16,12
021451c0,135005,136825,0,2,1820,16,12
0276137b,135005,137185,11,2,2180,16,12
06578a13,135005,137545,3,6,2540,16,12
09a8ca19,135005,137905,9,9,2900,16,12
0759dba6,135005,138265,6,7,3260,16,12
08a1289a,135005,138625,10,8,3620,16,12
05d7f0c0,135005,139345,0,5,4340,16,12
0bb36cb6,135005,139705,6,11,4700,16,12
09ebc9a0,135005,140065,0,9,5060,16,12
08cde4d6,135005,140425,6,8,5420,16,12
07c9c2e3,135005,140785,3,7,5780,16,12
054f61a3,135005,141145,3,5,6140,16,12
06cee615,135005,141505,5,6,6500,16,12
06b80a87,135005,141865,7,6,6860,16,12
017aec76,135005,142225,6,1,7220,16,12
08879a91,135005,142585,1,8,7580,16,12
02a4b152,135005,142945,2,2,7940,16,12
007fc516,135005,143305,6,0,8300,16,12
07b4b499,135005,143665,9,7,8660,16,12
0a83dc97,337015,337495,7,10,480,16,12
0a0e5368,337115,337855,8,10,740,16,12
04fb4aea,337445,338225,10,4,780,16,12
02e45923,337605,338655,3,2,1050,16,12
03dbf6b4,337335,339015,4,3,1680,16,12
043050d6,337965,339385,6,4,1420,16,12
065e7887,337375,339745,7,6,2370,16,12
004e02d8,337725,340105,8,0,2380,16,12
0b9b0c23,337835,340575,3,11,2740,16,12
084df284,337645,340935,4,8,3290,16,12
00e1bd14,438195,438645,4,0,450,16,12
05fe9536,438535,439015,6,5,480,16,12
06024419,438315,439405,9,6,1090,16,12
084f9d8a,438445,439765,10,8,1320,16,12
0361c860,438215,440135,0,3,1920,16,12
09f643b3,438385,440525,3,9,2140,16,12
02e4d126,539365,539935,6,2,570,16,12
04344b81,539465,540405,1,4,940,16,12
01535240,1075,1475,0,1,400,11,2
014d6090,12075,12785,0,1,710,11,2
01752120,12405,13505,0,1,1100,11,2
012d6121,34075,34455,0,1,380,11,2
0107ae80,34305,35175,0,1,870,11,2
00b22800,34785,35535,1,0,750,11,2
019650a1,35435,36615,0,1,1180,11,2
019650a1,35435,37335,0,1,1900,11,2
019650a1,35435,38055,0,1,2620,11,2
0028f1f0,135005,136105,0,0,1100,11,2
00caf2a1,337175,337835,1,0,660,11,2
01ff29c0,337415,338195,0,1,780,11,2
00dbc261,337495,338555,1,0,1060,11,2
00bb4a31,438065,438475,1,0,410,11,2
019a82f0,438135,438835,0,1,700,11,2
02535248,1005,1415,8,2,410,9,15
0695e818,12105,12485,11,6,380,9,15
064d6097,23085,23705,7,6,620,9,15
063f1767,23475,24335,7,6,860,9,15
0edcd3dc,34105,34685,6,14,580,9,15
02df78ce,34205,35045,7,2,840,9,15
09457ed4,34185,35655,6,9,1470,9,15
09a4b15a,135005,135385,10,9,380,9,15
07d7f0c1,135005,136105,1,7,1100,9,15
0228f1f5,135005,136465,5,2,1460,9,15
0bf3886c,135005,136825,12,11,1820,9,15
038565f1,135005,137185,1,3,2180,9,15
00fb6659,135005,137545,9,0,2540,9,15
08daddc7,135005,137905,7,8,2900,9,15
08e8a38a,135005,138265,10,8,3260,9,15
01724c6c,135005,138625,12,1,3620,9,15
0207ae85,135005,138985,5,2,3980,9,15
0042120e,135005,139345,14,0,4340,9,15
0474a021,135005,139705,1,4,4700,9,15
01e618a5,135005,140065,5,1,5060,9,15
03502bc4,135005,140425,4,3,5420,9,15
09da9f86,135005,140785,6,9,5780,9,15
0b7fc518,135005,141145,8,11,6140,9,15
0c5816d0,135005,141505,0,12,6500,9,15
05caf2a9,135005,141865,9,5,6860,9,15
059a82f8,135005,142225,8,5,7220,9,15
0a2e2ed0,135005,142585,0,10,7580,9,15
076adabb,135005,142945,11,7,7940,9,15
041340a1,135005,143305,1,4,8300,9,15
09b69dbb,135005,143665,11,9,8660,9,15
0c069f25,135005,144025,5,12,9020,9,15
0d3870a6,135005,144385,6,13,9380,9,15
08fdd6b8,135005,144745,8,8,9740,9,15
01bf9c6a,135005,145465,10,1,10460,9,15
006333a8,135005,145825,8,0,10820,9,15
015e276a,337095,337555,10,1,460,9,15
03b49ca1,337175,338335,1,3,1160,9,15
0572db62,337215,338695,2,5,1480,9,15
0d261f74,337435,339065,4,13,1630,9,15
0b49b045,337335,339425,5,11,2090,9,15
09807698,337515,339815,8,9,2300,9,15
0037195a,337235,340185,10,0,2950,9,15
0a18d886,438125,438595,6,10,470,9,15
0bcd928c,438225,439045,12,11,820,9,15
0e0042d6,438285,439555,6,14,1270,9,15
03567868,539495,540005,8,3,510,9,15
0ce07299,539335,540365,9,12,1030,9,15
071451c0,539215,540815,0,7,1600,9,15
01535244,1045,1555,4,1,510,14,7
0097b0d4,12215,12845,1,0,630,14,7
00f998d5,12255,13235,4,0,980,14,7
004d6094,12135,13605,6,0,1470,14,7
00284653,12305,14325,1,0,2020,14,7
00056632,12195,14755,6,0,2560,14,7
037cd0d2,23065,23525,2,3,460,14,7
033d2aa2,23525,23995,2,3,470,14,7
002d6122,23675,24465,2,0,790,14,7
05cdb8f4,34055,34845,1,5,790,14,7
06696ce0,34195,35205,2,6,1010,14,7
0607ae80,34205,35565,3,6,1360,14,7
03a4ec51,34265,35925,4,3,1660,14,7
0203e963,34865,36285,5,2,1420,14,7
02449236,35615,37005,0,2,1390,14,7
063870a5,34605,37365,1,6,2760,14,7
06572cf1,35525,38085,3,6,2560,14,7
05fe91d4,35445,38445,4,5,3000,14,7
02b34d85,35995,38805,5,2,2810,14,7
048bdf26,35955,39525,0,4,3570,14,7
0063eae1,35355,39885,1,0,4530,14,7
0614c3c0,35855,40245,2,6,4390,14,7
00513ae2,36225,40605,3,0,4380,14,7
02a12895,36055,40965,4,2,4910,14,7
047edc80,135005,135385,0,4,380,14,7
01b36cb4,135005,136105,4,1,1100,14,7
0265d935,135005,136825,5,2,1820,14,7
01fdd2a6,135005,137185,6,1,2180,14,7
05b4b496,135005,137905,6,5,2900,14,7
0190b2a2,135005,138625,2,1,3620,14,7
03bc4b81,135005,138985,1,3,3980,14,7
0149b044,135005,139345,4,1,4340,14,7
055fb4c1,135005,139705,1,5,4700,14,7
02d7f0c1,135005,140065,1,2,5060,14,7
02cd9280,337105,337495,0,2,390,14,7
037e4081,337405,337855,1,3,450,14,7
0618d882,337055,338215,2,6,1160,14,7
051451c4,337475,338585,4,5,1110,14,7
05530c70,337255,338975,0,5,1720,14,7
06c9c2e2,337355,339345,2,6,1990,14,7
01567862,438225,438685,2,1,460,14,7
017c63d3,438295,439045,3,1,750,14,7
05ea7664,438355,439405,4,5,1050,14,7
065c4700,438395,439795,0,6,1400,14,7
01199ba2,438525,440515,2,1,1990,14,7
05779fa0,438575,441285,0,5,2710,14,7
02737963,539125,539585,3,2,460,14,7
01921c00,539145,540335,0,1,1190,14,7
01535242,1095,1485,2,1,390,7,9
0797b0d3,12105,12525,4,7,420,7,9
0795e817,12055,12895,6,7,840,7,9
07056632,12095,13265,8,7,1170,7,9
06284653,23035,23505,3,6,470,7,9
043f1763,23145,24015,3,4,870,7,9
08dcd3d7,34035,34415,7,8,380,7,9
00de9f95,34205,34805,1,0,600,7,9
04457ed2,34085,35165,2,4,1080,7,9
053d2aa4,34315,35525,3,5,1210,7,9
05f62635,34865,35885,4,5,1020,7,9
00272773,34345,36245,5,0,1900,7,9
01421203,35015,36605,6,1,1590,7,9
08cdb8f3,34515,36965,7,8,2450,7,9
05a4ec56,34625,37325,8,5,2700,7,9
03b582d5,34775,37685,0,3,2910,7,9
063870a8,34885,38045,1,6,3160,7,9
0707ae80,34595,38405,2,7,3810,7,9
023b8132,35145,38765,3,2,3620,7,9
0214c3c5,35635,39125,4,2,3490,7,9
03fe91d3,35405,39485,5,3,4080,7,9
030f3787,35935,39845,6,3,3910,7,9
039650a1,35505,40205,7,3,4700,7,9
037d6532,35255,40925,0,3,5670,7,9
0662ad52,35295,41285,1,6,5990,7,9
0707ae80,34595,41645,2,7,7050,7,9
08a12894,36025,42015,4,8,5990,7,9
01488788,135005,135385,8,1,380,7,9
04a0c8e5,135005,135745,5,4,740,7,9
06292b36,135005,136105,6,6,1100,7,9
03265b66,135005,136465,6,3,1460,7,9
08241852,135005,136825,2,8,1820,7,9
01c4bd90,135005,137185,0,1,2180,7,9
074569f1,135005,137545,1,7,2540,7,9
03cdb120,135005,138265,0,3,3260,7,9
02563588,135005,138625,8,2,3620,7,9
08bb4a36,135005,138985,6,8,3980,7,9
0191ae66,135005,139345,6,1,4340,7,9
0179a0b8,135005,139705,8,1,4700,7,9
08a4b157,135005,140065,7,8,5060,7,9
06da9f88,135005,140425,8,6,5420,7,9
0433ed04,135005,140785,4,4,5780,7,9
02bf6d32,135005,141505,2,2,6500,7,9
00e94df5,337085,337465,5,0,380,7,9
0240cd04,438105,438535,4,2,430,7,9
0590b2a0,438165,438965,0,5,800,7,9
076adab2,438255,439335,2,7,1080,7,9
04ebc9a3,539155,539575,3,4,420,7,9
02535241,1015,1475,1,2,460,11,5
0195e812,12075,12455,4,1,380,11,5
014d6094,12085,12815,0,1,730,11,5
01f998d4,12225,13545,3,1,1320,11,5
013e3013,12385,13905,4,1,1520,11,5
0197b0d0,12185,14265,0,1,2080,11,5
01284653,12295,14995,3,1,2700,11,5
02457ed0,23085,23465,0,2,380,11,5
01cdb8f0,23625,24325,0,1,700,11,5
02069f24,34015,34445,4,2,430,11,5
01a4ec51,34225,34805,0,1,580,11,5
00b582d2,34385,35165,1,0,780,11,5
03845aa0,34755,35525,2,3,770,11,5
00696ce1,34095,35885,3,0,1790,11,5
003b8133,34915,36245,4,0,1330,11,5
0303e963,34825,36965,1,3,2140,11,5
01fe91d4,35255,37325,2,1,2070,11,5
0030aca2,35415,37685,3,0,2270,11,5
0214c3c2,35515,38045,4,2,2530,11,5
04449233,35355,38405,0,4,3050,11,5
0279a0b0,135005,135385,0,2,380,11,5
00ec0d72,135005,136105,2,0,1100,11,5
009e7390,135005,136465,0,0,1460,11,5
04e618a2,135005,136825,2,4,1820,11,5
01e32493,135005,137545,3,1,2540,11,5
005007e3,135005,137905,3,0,2900,11,5
02563583,135005,138265,3,2,3260,11,5
01502bc1,135005,138625,1,1,3620,11,5
03617732,337045,337495,2,3,450,11,5
03292b30,337235,337885,0,3,650,11,5
049a82f1,337175,338245,1,4,1070,11,5
018db5a2,337475,338605,2,1,1130,11,5
0391ae61,337445,339015,1,3,1570,11,5
00fc1292,337545,339375,2,0,1830,11,5
0136cda0,438095,438545,0,1,450,11,5
03fb6651,438145,438905,1,3,760,11,5
01ae2b50,438245,439315,0,1,1070,11,5
006adab2,539335,539725,2,0,390,11,5
0040cd03,539205,540085,3,0,880,11,5
0090b2a4,539275,540445,4,0,1170,11,5
00535241,1075,1465,1,0,390,3,2
01f998d0,23155,23825,0,1,670,3,2
00284650,34025,34425,1,0,400,3,2
017cd0d1,34195,34785,0,1,590,3,2
01fdd6b0,135005,135745,0,1,740,3,2
00e618a1,539145,539555,1,0,410,3,2
0553524b,1015,1535,11,5,520,9,12
0097b0d9,12105,12485,8,0,380,9,12
0095e81b,12025,12875,11,0,850,9,12
004d6093,12085,13595,1,0,1510,9,12
003e3013,12295,13955,2,0,1660,9,12
00056639,12095,14315,3,0,2220,9,12
00f998d5,12195,14725,7,0,2530,9,12
00284652,12245,15295,7,0,3050,9,12
083f176b,23075,23545,11,8,470,9,12
07457edb,23235,24115,11,7,880,9,12
03df78ca,34015,34785,6,3,770,9,12
01ff7e58,34295,35195,10,1,900,9,12
00724c66,34095,35645,4,0,1550,9,12
043d2aab,34235,36015,6,4,1780,9,12
09784c50,34165,36545,4,9,2380,9,12
0650deb2,135005,135745,2,6,740,9,12
0b2554f6,135005,136105,6,11,1100,9,12
011559f8,135005,136465,8,1,1460,9,12
0933ed0b,135005,136825,11,9,1820,9,12
01b4b49a,135005,137545,10,1,2540,9,12
01617736,135005,137905,6,1,2900,9,12
018db5a9,135005,138265,9,1,3260,9,12
012d6122,135005,138625,2,1,3620,9,12
0772665b,135005,138985,11,7,3980,9,12
04c380d4,135005,139345,4,4,4340,9,12
050f378a,135005,139705,10,5,4700,9,12
017be717,135005,140065,7,1,5060,9,12
03307622,135005,140425,2,3,5420,9,12
01e37893,135005,140785,3,1,5780,9,12
0525a775,135005,141145,5,5,6140,9,12
0b488785,135005,141505,5,11,6500,9,12
04599fa4,135005,141865,4,4,6860,9,12
04b36cb0,135005,142225,0,4,7220,9,12
00119790,135005,142585,0,0,7580,9,12
0b03e961,135005,143305,1,11,8300,9,12
06572cfb,135005,143665,11,6,8660,9,12
01daddc3,337075,337655,3,1,580,9,12
0bf72fd2,438125,438525,2,11,400,9,12
00102c3a,438175,439015,10,0,840,9,12
03eed561,438245,439405,1,3,1160,9,12
03bc4b85,539385,539925,5,3,540,9,12
031340a8,539145,540315,8,3,1170,9,12
054bf940,539475,540725,0,5,1250,9,12
00535248,1045,1595,8,0,550,12,9
034d6093,12065,12895,6,3,830,12,9
0397b0d4,12185,13255,7,3,1070,12,9
03752125,12345,13625,0,3,1280,12,9
03457ed4,12625,13985,1,3,1360,12,9
037cd0d2,12375,14345,2,3,1970,12,9
03dcd3d2,12575,15075,5,3,2500,12,9
03284656,12315,15445,7,3,3130,12,9
033f1767,12475,15815,0,3,3340,12,9
05272777,23365,23925,7,5,560,12,9
02069f27,23555,24435,7,2,880,12,9
05696ce4,34105,34645,1,5,540,12,9
0507ae81,34175,35005,2,5,830,12,9
0503e961,34905,35365,3,5,460,12,9
06e28bd2,34415,35725,4,6,1310,12,9
027d6535,35145,36445,6,2,1300,12,9
01fdd6b8,35205,36805,7,1,1600,12,9
03a4ec50,34275,37165,8,3,2890,12,9
01421201,34755,37525,0,1,2770,12,9
00b22807,34655,37885,1,0,3230,12,9
06726657,34455,38245,2,6,3790,12,9
018bdf26,35735,38965,4,1,3230,12,9
0414c3c8,35675,39325,5,4,3650,12,9
03a12898,36025,40045,7,3,4020,12,9
03265b61,36175,40405,8,3,4230,12,9
04572cf5,35435,40765,0,4,5330,12,9
02bf9c65,36265,41125,1,2,4860,12,9
010f3784,36005,41495,3,1,5490,12,9
0850deb1,36115,41855,4,8,5740,12,9
00ebc9a2,135005,135385,2,0,380,12,9
0549b040,135005,136105,0,5,1100,12,9
02fdd2a8,135005,136465,8,2,1460,12,9
025fb4c3,135005,136825,3,2,1820,12,9
007fc514,135005,137185,4,0,2180,12,9
05bf6d32,135005,137545,2,5,2540,12,9
00dbc268,135005,137905,8,0,2900,12,9
072e2ed0,135005,138265,0,7,3260,12,9
07bc4b87,135005,138625,7,7,3620,12,9
08371954,135005,138985,4,8,3980,12,9
051451c8,135005,139345,8,5,4340,12,9
05c4bd95,135005,139705,5,5,4700,12,9
0033ed07,135005,140065,7,0,5060,12,9
079e7393,135005,140425,3,7,5420,12,9
04ff29c5,135005,140785,5,4,5780,12,9
078db5a3,135005,141145,3,7,6140,12,9
00199ba6,337035,337475,6,0,440,12,9
01921c00,337455,337865,0,1,410,12,9
08737961,337425,338225,1,8,800,12,9
0561ab62,337585,338585,2,5,1000,12,9
06ab35e3,337055,338945,3,6,1890,12,9
01779fa4,337075,339305,4,1,2230,12,9
06761375,337335,339665,5,6,2330,12,9
014f61a6,337255,340025,6,1,2770,12,9
05000b93,337305,340475,3,5,3170,12,9
0059f264,337535,340835,4,0,3300,12,9
08a9b7e7,438285,438675,7,8,390,12,9
063ff788,438265,439035,8,6,770,12,9
05157860,438185,439395,0,5,1210,12,9
00d80db2,438315,439765,2,0,1450,12,9
01409174,539195,539685,4,1,490,12,9
04578a16,539255,540055,6,4,800,12,9
06535249,1005,1655,9,6,650,1,14
0695e814,12085,12585,5,6,500,1,14
09284651,34245,34825,0,9,580,1,14
0327277d,34785,35195,2,3,410,1,14
06dcd3dc,34475,35555,3,6,1080,1,14
02f998d1,34215,35915,4,2,1700,1,14
0b7cd0d2,34325,36275,5,11,1950,1,14
0c3d2aa1,34725,36645,7,12,1920,1,14
07de9f98,34605,37005,8,7,2400,1,14
07ff7e54,34745,37365,9,7,2620,1,14
0897b0dd,34185,37735,11,8,3550,1,14
05724c65,34625,38095,12,5,3470,1,14
06dcd3dc,34475,38525,3,6,4050,1,14
02f998d1,34215,38885,4,2,4670,1,14
0b7cd0d2,34325,39245,5,11,4920,1,14
0897b0dd,34185,39695,11,8,5510,1,14
043870a3,135005,135385,3,4,380,1,14
01b22804,135005,135745,4,1,740,1,14
0c421207,135005,136105,7,12,1100,1,14
06845aac,135005,136465,12,6,1460,1,14
02ccc9d6,135005,136825,6,2,1820,1,14
0c069f2a,135005,137185,10,12,2180,1,14
00696ce6,135005,137545,6,0,2540,1,14
0907ae80,135005,137905,0,9,2900,1,14
04e28bdd,135005,138985,13,4,3980,1,14
08b582da,135005,139345,10,8,4340,1,14
04f62631,135005,140065,1,4,5060,1,14
053b813b,337035,337575,11,5,540,1,14
07c380dd,539075,539685,13,7,610,1,14
0f53524c,1075,1555,12,15,480,7,16
04056630,12295,12675,1,4,380,7,16
0495e810,12105,13045,3,4,940,7,16
044d6094,12195,13515,10,4,1320,7,16
0497b0d7,12325,13885,12,4,1560,7,16
0bf998d8,23095,23485,8,11,390,7,16
093e3018,23325,24135,8,9,810,7,16
0d7cd0db,34045,34445,6,13,400,7,16
02de9f94,34475,34915,13,2,440,7,16
07ff7e5e,34705,35275,14,7,570,7,16
013d2aa7,34665,35635,15,1,970,7,16
02696ce2,34935,35995,0,2,1060,7,16
0ddf78ce,34385,36355,1,13,1970,7,16
0a069f2e,34895,36715,2,10,1820,7,16
07457ed5,34315,37075,3,7,2760,7,16
0fdcd3de,34225,37435,4,15,3210,7,16
03724c6c,34575,37795,5,3,3220,7,16
023f1769,34145,38155,6,2,4010,7,16
03784c5b,34625,38515,7,3,3890,7,16
01272773,34785,39235,9,1,4450,7,16
032d6127,34815,39595,10,3,4780,7,16
0003e969,35515,39955,11,0,4440,7,16
0e726655,35245,40675,13,14,5430,7,16
00f6263b,35255,41035,14,0,5780,7,16
0c3870a6,35295,41395,15,12,6100,7,16
063b8131,35595,41755,0,6,6160,7,16
0630aca7,36145,42115,1,6,5970,7,16
0063eaef,35845,42475,2,0,6630,7,16
0644923e,36035,42835,3,6,6800,7,16
0e502bcd,36865,43195,4,14,6330,7,16
01bf9c68,36745,43555,5,1,6810,7,16
0c0f378a,36425,43915,6,12,7490,7,16
0cfdd2af,36925,44275,7,12,7350,7,16
054b341f,36335,44645,9,5,8310,7,16
05fe91d3,35855,45005,10,5,9150,7,16
0c513ae1,36815,45365,11,12,8550,7,16
0050debb,36575,45725,12,0,9150,7,16
02b34d8c,36345,46085,13,2,9740,7,16
0b9650a9,36065,46805,15,11,10740,7,16
0a265b66,36655,47165,0,10,10510,7,16
09ec0d75,135005,135385,5,9,380,7,16
092ed3d6,135005,135745,6,9,740,7,16
0292f85a,135005,136105,10,2,1100,7,16
09f38865,135005,136465,5,9,1460,7,16
0d9a82fd,135005,136825,13,13,1820,7,16
098db5a0,135005,137185,0,9,2180,7,16
01119798,135005,137545,8,1,2540,7,16
08ebc9ae,135005,137905,14,8,2900,7,16
04fb9b6c,135005,138265,12,4,3260,7,16
0572db6e,135005,138985,14,5,3980,7,16
0b18d882,135005,139345,2,11,4340,7,16
0a7a6fd8,135005,139705,8,10,4700,7,16
0a7be710,135005,140065,0,10,5060,7,16
05d60b7c,135005,140785,12,5,5780,7,16
0b7edc89,135005,141145,9,11,6140,7,16
0328f1f5,135005,141505,5,3,6500,7,16
0ccaf2a1,135005,141865,1,12,6860,7,16
0361773b,135005,142225,11,3,7220,7,16
00b36cbc,135005,142585,12,0,7580,7,16
00ae2b50,135005,142945,0,0,7940,7,16
02fcf0e1,135005,143305,1,2,8300,7,16
0997667d,135005,143665,13,9,8660,7,16
035e2767,135005,144385,7,3,9380,7,16
0a807699,135005,144745,9,10,9740,7,16
0a7c63d0,135005,145465,0,10,10460,7,16
013327ed,135005,145825,13,1,10820,7,16
009a18f0,135005,146185,0,0,11180,7,16
0ce32494,135005,146545,4,12,11540,7,16
0050473e,337105,337635,14,0,530,7,16
0bab35e4,438175,438605,4,11,430,7,16
03e05d5b,438335,439075,11,3,740,7,16
07779fa1,438255,439525,1,7,1270,7,16
0559f268,539395,539905,8,5,510,7,16
0495e813,12075,12525,10,4,450,11,16
04056632,12165,12895,12,4,730,11,16
044d6094,12095,13325,1,4,1230,11,16
0497b0dc,12245,13815,9,4,1570,11,16
04f998db,12285,14175,10,4,1890,11,16
08752120,23055,23645,0,8,590,11,16
037cd0d0,23115,24295,0,3,1180,11,16
09df78c1,34145,34625,15,9,480,11,16
0edcd3df,34075,34985,0,14,910,11,16
04696ce2,34825,35345,1,4,520,11,16
0a784c5c,34315,35705,2,10,1390,11,16
093f176c,34045,36065,3,9,2020,11,16
0507ae85,34915,36425,4,5,1510,11,16
06f6263b,35265,36785,5,6,1520,11,16
0c572cf5,36255,37145,6,12,890,11,16
06069f27,34725,37505,7,6,2780,11,16
09457ed8,34135,37865,8,9,3730,11,16
04b582dd,35155,38225,9,4,3070,11,16
0d272772,34475,38585,10,13,4110,11,16
073d2aa1,34415,38945,11,7,4530,11,16
08724c6a,34245,39305,12,8,5060,11,16
068495c0,35065,39665,13,6,4600,11,16
083870a4,35365,40025,14,8,4660,11,16
04ff7e5e,34425,40385,15,4,5960,11,16
083b8130,35715,40745,0,8,5030,11,16
0a42120d,35455,41105,1,10,5650,11,16
0d03e96e,35625,42185,4,13,6560,11,16
0aa1289f,36885,42905,6,10,6020,11,16
0d9650a1,36365,43265,7,13,6900,11,16
0eb34d8e,36775,43625,8,14,6850,11,16
0c72665f,35225,43985,9,12,8760,11,16
0914c3c2,36505,44345,10,9,7840,11,16
08a4ec52,34965,44715,12,8,9750,11,16
02e618af,36665,45105,15,2,8440,11,16
05449235,36295,45465,0,5,9170,11,16
02fdd6b1,35915,45825,1,2,9910,11,16
0d74a02d,36055,46185,2,13,10130,11,16
0b25a775,135005,135385,5,11,380,11,16
07b4b495,135005,135745,5,7,740,11,16
0d9a82fd,135005,136105,13,13,1100,11,16
02f72fdf,135005,136825,15,2,1820,11,16
0465d93b,135005,137185,11,4,2180,11,16
0871a466,135005,137545,6,8,2540,11,16
0d1451c7,135005,137905,7,13,2900,11,16
09ab35ee,135005,138265,14,9,3260,11,16
06f0fdc2,135005,138625,2,6,3620,11,16
06791862,135005,138985,2,6,3980,11,16
010168a7,135005,139345,7,1,4340,11,16
0b5ff9ed,135005,139705,13,11,4700,11,16
08265b66,135005,140065,6,8,5060,11,16
093327e7,135005,140425,7,9,5420,11,16
03d945c0,135005,140785,0,3,5780,11,16
04488786,135005,141145,6,4,6140,11,16
0c617738,135005,141505,8,12,6500,11,16
082e2edf,135005,141865,15,8,6860,11,16
07daddc4,135005,142225,4,7,7220,11,16
0ebc4b80,135005,142585,0,14,7580,11,16
0372db63,135005,142945,3,3,7940,11,16
05c9c2ee,135005,143305,14,5,8300,11,16
0c504736,135005,143665,6,12,8660,11,16
0e61ab6e,135005,144025,14,14,9020,11,16
02409178,135005,144385,8,2,9380,11,16
01c42738,135005,144745,8,1,9740,11,16
03a1d2a7,135005,145105,7,3,10100,11,16
0659dba7,135005,145465,7,6,10460,11,16
0ac603b6,135005,145825,6,10,10820,11,16
0fd60b74,135005,146185,4,15,11180,11,16
09ccec2d,135005,146545,13,9,11540,11,16
01e5ebd7,337075,337495,7,1,420,11,16
02fcd849,337115,337865,9,2,750,11,16
02879a9d,337285,338275,13,2,990,11,16
07b6afbf,337365,338645,15,7,1280,11,16
079a4e43,337165,339055,3,7,1890,11,16
023cfca4,337265,339415,4,2,2150,11,16
075a98e5,337335,339775,5,7,2440,11,16
035a8a16,337295,340135,6,3,2840,11,16
0a83dc97,438245,438735,7,10,490,11,16
0f0e5360,438345,439585,0,15,1240,11,16
0b8568f7,438535,440055,7,11,1520,11,16
03dbf6b6,539025,539445,6,3,420,11,16
04e45922,539245,539835,2,4,590,11,16
0375f4b4,539375,540205,4,3,830,11,16
0b9b0c20,539445,540775,0,11,1330,11,16
02535246,1005,1435,6,2,430,11,8
0195e812,12065,12545,3,1,480,11,8
01056637,12135,12935,6,1,800,11,8
014d6096,12125,13305,0,1,1180,11,8
0497b0d5,23015,23425,5,4,410,11,8
06457ed1,34305,34885,3,6,580,11,8
007cd0d3,34135,35255,5,0,1120,11,8
07752124,34085,35615,6,7,1530,11,8
00724c60,34485,35975,7,0,1490,11,8
05696ce1,34945,36335,0,5,1390,11,8
06784c57,34505,36705,2,6,2200,11,8
033b8130,35735,37425,4,3,1690,11,8
0207ae83,34985,37785,5,2,2800,11,8
05069f25,34895,38145,6,5,3250,11,8
077d6536,35885,38865,0,7,2980,11,8
04845aa5,35545,39235,2,4,3690,11,8
06c380d6,35825,39595,3,6,3770,11,8
06b22800,35455,39965,5,6,4510,11,8
011559f1,135005,135385,1,1,380,11,8
037fc512,135005,135745,2,3,740,11,8
0328f1f0,135005,136105,0,3,1100,11,8
03ff29c1,135005,136465,1,3,1460,11,8
0091ae64,135005,136825,4,0,1820,11,8
0562ad52,135005,137185,2,5,2180,11,8
044b3417,135005,137545,7,4,2540,11,8
077be716,135005,137905,6,7,2900,11,8
025816d7,135005,138625,7,2,3620,11,8
07f38867,135005,138985,7,7,3980,11,8
078fdf75,135005,139345,5,7,4340,11,8
011ff441,135005,139705,1,1,4700,11,8
018bdf26,135005,140065,6,1,5060,11,8
06fdd2a2,135005,140425,2,6,5420,11,8
05307626,135005,140785,6,5,5780,11,8
0390b2a2,337075,337555,2,3,480,11,8
00ebc9a3,337295,337915,3,0,620,11,8
06102c30,337425,338345,0,6,920,11,8
03eed562,337475,338715,2,3,1240,11,8
05f72fd3,337345,339075,3,5,1730,11,8
07187796,438305,438735,6,7,430,11,8
01e8a387,438265,439095,7,1,830,11,8
011340a0,438165,439455,0,1,1290,11,8
01f2c042,438625,439825,2,1,1200,11,8
00bc4b83,438385,440185,3,0,1800,11,8
0665d937,438525,440925,7,6,2400,11,8
050b7d92,539175,539565,2,5,390,11,8
07cde4d6,539165,539975,6,7,810,11,8
0e535241,1035,1575,1,14,540,14,15
0595e816,12025,12565,0,5,540,14,15
05284657,12355,12925,1,5,570,14,15
054d6095,12045,13285,2,5,1240,14,15
053e3017,12465,13645,3,5,1180,14,15
05f998d7,12315,14035,6,5,1720,14,15
0505663c,12135,14395,7,5,2260,14,15
0597b0d0,12215,14925,2,5,2710,14,15
05752126,12455,15335,6,5,2880,14,15
087cd0d5,23035,23665,5,8,630,14,15
0a3d2aa5,23655,24295,5,10,640,14,15
07069f22,34275,34895,0,7,620,14,15
0c27277c,34015,35285,3,12,1270,14,15
01cdb8fc,34195,35715,8,1,1520,14,15
04696cec,34335,36085,10,4,1750,14,15
0407ae89,34405,36455,12,4,2050,14,15
098495ce,34535,36815,13,9,2280,14,15
05e28bda,34595,37785,13,5,3190,14,15
0e292b33,135005,135385,3,14,380,14,15
051ff440,135005,135745,0,5,740,14,15
02e8a387,135005,136105,7,2,1100,14,15
0037195e,135005,136465,14,0,1460,14,15
0ce0729b,135005,136825,11,12,1820,14,15
0a761377,135005,137185,7,10,2180,14,15
07cee610,135005,137545,0,7,2540,14,15
020168ae,135005,137905,14,2,2900,14,15
054e3c8b,135005,138265,11,5,3260,14,15
0272665d,135005,138625,13,2,3620,14,15
0563eae1,135005,138985,1,5,3980,14,15
00265b62,135005,139345,2,0,4340,14,15
07c4bd96,135005,139705,6,7,4700,14,15
0d7fc517,135005,140065,7,13,5060,14,15
02488789,135005,140425,9,2,5420,14,15
03e94df4,135005,140785,4,3,5780,14,15
021340a9,135005,141145,9,2,6140,14,15
01b49ca9,135005,141505,9,1,6500,14,15
021451cd,135005,141865,13,2,6860,14,15
0e4f61ab,135005,142225,11,14,7220,14,15
0ed2b79d,135005,142585,13,14,7580,14,15
05c42738,135005,142945,8,5,7940,14,15
06de6388,135005,143305,8,6,8300,14,15
0e62ad57,135005,144025,7,14,9020,14,15
00a12892,135005,144385,2,0,9380,14,15
0ca4b154,135005,144745,4,12,9740,14,15
0d33ed0a,135005,145105,10,13,10100,14,15
02bf6d3c,135005,145465,12,2,10460,14,15
04e5ebd7,337065,337495,7,4,430,14,15
0c9a4e4b,337205,337905,11,12,700,14,15
0afcd842,337165,338355,2,10,1190,14,15
01879a97,337385,339115,7,1,1730,14,15
035a8a19,438045,438445,9,3,400,14,15
0b0e5365,438515,438965,5,11,450,14,15
0bfb4ae7,438775,439685,7,11,910,14,15
0be45929,438925,440055,9,11,1130,14,15
09290efb,438375,440425,11,9,2050,14,15
0514875c,438585,440785,12,5,2200,14,15
025e788e,438705,441155,14,2,2450,14,15
0cdbf6b2,438695,441545,2,12,2850,14,15
018568f5,438665,441935,5,1,3270,14,15
01cf61e7,539285,539895,7,1,610,14,15
069fdec8,539395,540255,8,6,860,14,15
0e9b0c21,539185,540745,1,14,1560,14,15
01535242,1045,1495,2,1,450,11,5
0395e813,12105,12485,1,3,380,11,5
034d6093,12205,12915,1,3,710,11,5
04056631,23105,23485,1,4,380,11,5
00752121,23265,23915,1,0,650,11,5
043e3013,34085,34465,0,4,380,11,5
003f1760,34195,34825,1,0,630,11,5
01457ed2,34295,35185,2,1,890,11,5
00ff7e52,34715,35905,4,0,1190,11,5
04dcd3d3,34285,36265,0,4,1980,11,5
023d2aa4,34615,36625,1,2,2010,11,5
00726653,35285,37345,3,0,2060,11,5
02fdd6b2,35955,38065,0,2,2110,11,5
03b34d84,36575,38425,1,3,1850,11,5
01572cf3,36195,38785,2,1,2590,11,5
0014c3c4,36375,39145,3,0,2770,11,5
02fdd6b2,35955,39865,0,2,3910,11,5
02265b60,36925,40225,1,2,3300,11,5
0433ed00,135005,135745,0,4,740,11,5
045816d1,135005,136105,1,4,1100,11,5
01fdd2a4,135005,136825,4,1,1820,11,5
03e37891,135005,137185,1,3,2180,11,5
00cdb123,135005,137545,3,0,2540,11,5
04caf2a0,135005,137905,0,4,2900,11,5
008565f1,135005,138265,1,0,3260,11,5
0199bf12,135005,138625,2,1,3620,11,5
0436cda0,337045,337455,0,4,410,11,5
02119791,337305,337815,1,2,510,11,5
00e94df2,337235,338175,2,0,940,11,5
041ff443,337315,338535,3,4,1220,11,5
00fb6654,337125,338895,4,0,1770,11,5
04ae2b50,337135,339255,0,4,2120,11,5
02daddc4,438215,438655,4,2,440,11,5
04102c32,438325,439385,2,4,1060,11,5
04f72fd3,438275,439745,3,4,1470,11,5
019e94e4,438425,440105,4,1,1680,11,5
0853524c,1085,1555,12,8,470,4,16
0b95e816,12045,12525,10,11,480,4,16
0b97b0d5,12255,12955,15,11,700,4,16
0b05663a,12215,13405,5,11,1190,4,16
0b4d6091,12125,13765,6,11,1640,4,16
0ff998de,23055,23605,14,15,550,4,16
06752123,34135,34605,14,6,470,4,16
0e3f1761,34315,35375,3,14,1060,4,16
083e3016,34175,35735,4,8,1560,4,16
013d2aaa,34615,36105,6,1,1490,4,16
047cd0d8,34225,36465,7,4,2240,4,16
0a069f20,34995,36835,9,10,1840,4,16
08df78cc,34475,37195,10,8,2720,4,16
02de9f9b,34485,37555,11,2,3070,4,16
0b457ed8,34395,37915,12,11,3520,4,16
0bcdb8ff,34905,38275,13,11,3370,4,16
00724c64,34525,38635,14,0,4110,4,16
098495ce,35225,38995,15,9,3770,4,16
09ff7e5d,34665,39385,2,9,4720,4,16
06dcd3df,34355,39755,4,6,5400,4,16
00b582d4,35375,40145,7,0,4770,4,16
07272777,34735,40535,10,7,5800,4,16
0f696ce4,35055,40895,11,15,5840,4,16
0f07ae8c,35095,41255,12,15,6160,4,16
0e726651,35475,41705,2,14,6230,4,16
0bfe91d8,135005,135385,8,11,380,4,16
0030acad,135005,135745,13,0,740,4,16
074b341a,135005,136105,10,7,1100,4,16
0950deb2,135005,136465,2,9,1460,4,16
0e502bc7,135005,136825,7,14,1820,4,16
0a3327ed,135005,137545,13,10,2540,4,16
0e307628,135005,137905,8,14,2900,4,16
0dda9f82,135005,138265,2,13,3260,4,16
08bc05b5,135005,138625,5,8,3620,4,16
04ec0d74,135005,138985,4,4,3980,4,16
06ccec21,135005,139345,1,6,4340,4,16
0eb22807,135005,140065,7,14,5060,4,16
0903e96d,135005,140425,13,9,5420,4,16
05fdd6b2,135005,140785,2,5,5780,4,16
0c48878a,337015,337555,10,12,540,4,16
07caf2a1,539245,539935,1,7,690,4,16
08535240,1065,1455,0,8,390,9,11
054d6095,12115,12525,3,5,410,9,11
0597b0d6,12235,13265,7,5,1030,9,11
0595e811,12105,13625,8,5,1520,9,11
0528465a,12385,14015,0,5,1630,9,11
053e3013,12535,14375,1,5,1840,9,11
05f998d8,12335,14735,2,5,2400,9,11
05752127,12435,15165,7,5,2730,9,11
057cd0d8,12615,15615,2,5,3000,9,11
073f176a,23085,23665,10,7,580,9,11
04457eda,34115,34525,3,4,410,9,11
05ff7e54,34405,34885,4,5,480,9,11
02df78c2,34205,35245,5,2,1040,9,11
07272773,34485,35605,6,7,1120,9,11
06784c51,34315,35965,7,6,1650,9,11
09dcd3d3,34085,36325,8,9,2240,9,11
043d2aa5,34345,37045,10,4,2700,9,11
0a74a025,35615,37405,0,10,1790,9,11
07b582d9,34915,37765,1,7,2850,9,11
03cdb8fa,34605,38125,2,3,3520,9,11
01de9f9a,34225,38485,3,1,4260,9,11
02421204,35205,38845,4,2,3640,9,11
06e28bd4,34835,39205,5,6,4370,9,11
09a4ec52,34785,39565,6,9,4780,9,11
0330aca2,35845,39925,7,3,4080,9,11
059650a4,35835,40285,8,5,4450,9,11
04c380da,35495,40655,10,4,5160,9,11
07fdd6b3,35525,41025,1,7,5500,9,11
093b813a,35455,41385,2,9,5930,9,11
00e618aa,35975,41745,3,0,5770,9,11
018bdf28,35965,42105,4,1,6140,9,11
047d6539,35505,42465,5,4,6960,9,11
00449239,35755,42825,6,0,7070,9,11
048fdf73,135005,135385,3,4,380,9,11
07e94df3,135005,135745,3,7,740,9,11
05bc4b85,135005,136465,5,5,1460,9,11
01b34d82,135005,136825,2,1,1820,9,11
0a79a0b6,135005,137185,6,10,2180,9,11
05c4bd91,135005,137545,1,5,2540,9,11
037edc80,135005,138265,0,3,3260,9,11
09ff29c8,135005,138985,8,9,3980,9,11
05fb6654,135005,139345,4,5,4340,9,11
05daddc9,135005,139705,9,5,4700,9,11
06e8a38a,135005,140065,10,6,5060,9,11
020b7d97,135005,140425,7,2,5420,9,11
06502bc4,135005,140785,4,6,5780,9,11
04a4b159,135005,141145,9,4,6140,9,11
044569f3,135005,141505,3,4,6500,9,11
08d7f0c1,135005,141865,1,8,6860,9,11
0728f1f1,135005,142225,1,7,7220,9,11
06f38862,135005,142585,2,6,7580,9,11
058565f1,135005,142945,1,5,7940,9,11
06807695,337015,337455,5,6,440,9,11
06ebab48,337085,337845,8,6,760,9,11
0a18d881,337115,338255,1,10,1140,9,11
000042d7,438115,438615,7,0,500,9,11
00530c79,438185,438985,9,0,800,9,11
02c9c2e4,438235,439435,4,2,1200,9,11
06e07292,539235,539665,2,6,430,9,11
047901c6,539275,540075,6,4,800,9,11
05535241,1055,1455,1,5,400,6,6
0295e815,12025,12505,3,2,480,6,6
04056630,23095,23565,0,4,470,6,6
04284650,23295,24015,0,4,720,6,6
01752120,34055,34505,3,1,450,6,6
02dcd3d4,34255,34875,5,2,620,6,6
053f1765,34245,35595,1,5,1350,6,6
00724c60,34395,35955,2,0,1560,6,6
01df78c2,34315,36315,3,1,2000,6,6
03069f24,34825,36685,5,3,1860,6,6
02de9f91,34385,37405,1,2,3020,6,6
04696ce3,34885,37765,2,4,2880,6,6
0507ae84,34915,38125,3,5,3210,6,6
05fe91d3,135005,135385,3,5,380,6,6
018bdf20,135005,135745,0,1,740,6,6
0150deb1,135005,136105,1,1,1100,6,6
02b22800,135005,136825,0,2,1820,6,6
01c380d2,135005,137185,2,1,2180,6,6
0530aca5,135005,137545,5,5,2540,6,6
050f3782,135005,137905,2,5,2900,6,6
03502bc4,135005,138265,4,3,3260,6,6
01f62635,135005,138625,5,1,3620,6,6
0403e964,135005,138985,4,4,3980,6,6
0074a025,135005,139345,5,0,4340,6,6
04c603b3,337105,337535,3,4,430,6,6
006333a2,438075,438465,2,0,390,6,6
043327e1,438085,438895,1,4,810,6,6
05a4b153,539105,539535,3,5,430,6,6
0499bf15,539115,539905,5,4,790,6,6
01535242,1035,1515,2,1,480,9,8
0595e814,12025,12445,6,5,420,9,8
064d6094,23015,23405,4,6,390,9,8
00752124,23245,23895,4,0,650,9,8
003e3012,34105,34505,1,0,400,9,8
013b8131,135005,135385,1,1,380,9,8
00a12892,135005,136105,2,0,1100,9,8
00241855,135005,136465,5,0,1460,9,8
045fb4c2,135005,136825,2,4,1820,9,8
073f1767,135005,137185,7,7,2180,9,8
05b582d1,135005,137905,1,5,2900,9,8
05fe91d3,135005,138265,3,5,3260,9,8
01b34d87,135005,138625,7,1,3620,9,8
0679a0b2,135005,138985,2,6,3980,9,8
04c4bd97,135005,139345,7,4,4340,9,8
05bc05b6,135005,139705,6,5,4700,9,8
013d2aa2,135005,140065,2,1,5060,9,8
038495c4,135005,140425,4,3,5420,9,8
00d7f0c6,337105,337485,6,0,380,9,8
027edc87,337135,337845,7,2,710,9,8
02ccec20,337115,338205,0,2,1090,9,8
025816d3,337485,338595,3,2,1110,9,8
07cdb124,337315,338955,4,7,1640,9,8
009e7395,337495,339315,5,0,1820,9,8
032ed3d6,337235,339675,6,3,2440,9,8
025007e7,337415,340035,7,2,2620,9,8
0525a770,337215,340395,0,5,3180,9,8
0392f850,438165,439285,0,3,1120,9,8
02a595b0,539045,539555,0,2,510,9,8
03535241,1005,1475,1,3,470,3,5
0195e812,12105,12545,4,1,440,3,5
034d6091,23035,23485,1,3,450,3,5
00056631,23115,23915,1,0,800,3,5
0097b0d1,34025,34485,1,0,460,3,5
00752120,34245,35205,3,0,960,3,5
043e3011,34265,35925,0,4,1660,3,5
04284653,34185,36285,1,4,2100,3,5
01ff7e51,34725,36645,2,1,1920,3,5
023f1761,34355,37005,3,2,2650,3,5
02069f20,34905,37365,4,2,2460,3,5
013d2aa0,34685,37725,0,1,3040,3,5
00df78c2,34505,38085,1,0,3580,3,5
02b22804,135005,135385,4,2,380,3,5
04ccc9d3,135005,135745,3,4,740,3,5
00c380d3,135005,136105,3,0,1100,3,5
03726653,135005,136825,3,3,1820,3,5
04572cf3,337025,337415,3,4,390,3,5
0330aca4,539125,539555,4,3,430,3,5
04535241,1085,1495,1,4,410,12,8
0295e814,12055,12505,1,2,450,12,8
0297b0d5,12225,12935,6,2,710,12,8
02056637,12145,13305,0,2,1160,12,8
024d6094,12095,13665,1,2,1570,12,8
02f998d5,12235,14135,0,2,1900,12,8
02284655,23075,23585,5,2,510,12,8
02752124,34045,34465,7,2,420,12,8
02724c64,34445,34825,0,2,380,12,8
013e3012,34105,35545,2,1,1440,12,8
057cd0d2,34145,35905,3,5,1760,12,8
033f1765,34215,36625,5,3,2410,12,8
03c380d2,35905,36985,6,3,1080,12,8
03df78c4,34355,37345,7,3,2990,12,8
02784c51,34545,37705,0,2,3160,12,8
0007ae86,35085,38065,1,0,2980,12,8
00421206,35545,38425,2,0,2880,12,8
073b8134,35845,38785,3,7,2940,12,8
0003e967,35785,39145,4,0,3360,12,8
0730aca6,36575,39505,5,7,2930,12,8
049650a0,36475,39875,7,4,3400,12,8
05449236,36465,40595,1,5,4130,12,8
03e618a1,36685,40955,2,3,4270,12,8
028bdf20,36675,41315,3,2,4640,12,8
017edc86,135005,135385,6,1,380,12,8
04e94df7,135005,136465,7,4,1460,12,8
029e94e4,135005,136825,4,2,1820,12,8
04b34d83,135005,137185,3,4,2180,12,8
042554f7,135005,137545,7,4,2540,12,8
06d60b70,135005,137905,0,6,2900,12,8
07488786,135005,138265,6,7,3260,12,8
01fb6653,135005,138985,3,1,3980,12,8
04102c32,135005,139345,2,4,4340,12,8
067ca590,135005,139705,0,6,4700,12,8
027be711,135005,140065,1,2,5060,12,8
009a18f6,135005,140425,6,0,5420,12,8
06d7f0c7,135005,140785,7,6,5780,12,8
03ebab46,337085,337475,6,3,390,12,8
07807694,337075,337925,4,7,850,12,8
0018d885,337155,338285,5,0,1130,12,8
077e4086,438325,438795,6,7,470,12,8
07e07290,438475,439165,0,7,690,12,8
051451c1,438345,439525,1,5,1180,12,8
01567865,438595,439935,5,1,1340,12,8
057901c6,438545,440295,6,5,1750,12,8
04504736,539335,539805,6,4,470,12,8
08535244,1085,1535,4,8,450,11,11
0195e810,12025,12565,5,1,540,11,11
014d6091,12125,12935,7,1,810,11,11
0897b0d3,23085,23525,3,8,440,11,11
07f998d3,23185,24075,3,7,890,11,11
07284659,34025,34585,6,7,560,11,11
04df78c2,34575,35315,9,4,740,11,11
053e3016,34215,35675,10,5,1460,11,11
09a4ec54,35255,36035,0,9,780,11,11
06de9f94,34645,36395,1,6,1750,11,11
0a3d2aa8,34795,36755,2,10,1960,11,11
0aff7e51,34855,37115,3,10,2260,11,11
0a3f1767,34325,37475,4,10,3150,11,11
082d6128,34935,37835,5,8,2900,11,11
0707ae83,35175,38195,6,7,3020,11,11
0a724c64,34705,38555,7,10,3850,11,11
03ccc9d8,36005,38915,8,3,2910,11,11
00696ce3,35095,39275,9,0,4180,11,11
01457ed6,34485,39635,10,1,5150,11,11
08845aa7,35905,39995,0,8,4090,11,11
07e28bd2,35395,40355,1,7,4960,11,11
09b22809,35765,40725,3,9,4960,11,11
03f62631,35695,41085,4,3,5390,11,11
0a421203,35815,41445,5,10,5630,11,11
003870a5,35715,41805,6,0,6090,11,11
028565f8,135005,135385,8,2,380,11,11
0ae94df5,135005,135745,5,10,740,11,11
00eed567,135005,136105,7,0,1100,11,11
077ca596,135005,136465,6,7,1460,11,11
0730aca3,135005,137185,3,7,2180,11,11
09513ae8,135005,137545,8,9,2540,11,11
0199bf14,135005,137905,4,1,2900,11,11
09e37892,135005,138265,2,9,3260,11,11
00cdb121,135005,138625,1,0,3620,11,11
03caf2a9,135005,138985,9,3,3980,11,11
02fb665a,135005,139345,10,2,4340,11,11
05f72fd3,135005,139705,3,5,4700,11,11
0465d930,135005,140065,0,4,5060,11,11
0171a465,135005,140425,5,1,5420,11,11
08449236,135005,140785,6,8,5780,11,11
02265b69,135005,141145,9,2,6140,11,11
0a3327e7,135005,141505,7,10,6500,11,11
0325a777,135005,142225,7,3,7220,11,11
04b4b497,135005,142585,7,4,7580,11,11
039a82f3,135005,142945,3,3,7940,11,11
0a1451c5,337095,337675,5,10,580,11,11
017a6fd6,337115,338035,6,1,920,11,11
03567860,337365,338465,0,3,1100,11,11
04e07295,337215,339225,5,4,2010,11,11
097c63d5,438135,438585,5,9,450,11,11
08ea766a,438195,439015,10,8,820,11,11
095c4701,438275,439385,1,9,1110,11,11
05779faa,539295,540335,10,5,1040,11,11
07761370,539455,540695,0,7,1240,11,11
0795e815,12045,12485,6,7,440,3,10
07056636,12105,12895,0,7,790,3,10
074d6096,12075,13255,1,7,1180,3,10
0897b0d9,23035,23545,9,8,510,3,10
057cd0d0,34185,34565,0,5,380,3,10
07284657,34025,34925,1,7,900,3,10
01724c66,34465,35295,3,1,830,3,10
08752123,34125,36025,6,8,1900,3,10
01df78c6,34405,36385,7,1,1980,3,10
00f62638,35245,36745,8,0,1500,3,10
08de9f92,34425,37465,0,8,3040,3,10
072d6125,34805,37855,3,7,3050,3,10
02a4ec51,35085,38225,5,2,3140,3,10
00726652,35235,38585,6,0,3350,3,10
0307ae88,34995,39315,9,3,4320,3,10
08de9f92,34425,39675,0,8,5250,3,10
00ccc9d7,135005,135385,7,0,380,3,10
08c380d7,135005,135745,7,8,740,3,10
0462ad55,135005,136105,5,4,1100,3,10
08fe91d1,135005,136465,1,8,1460,3,10
049650a0,135005,136825,0,4,1820,3,10
048bdf29,135005,137185,9,4,2180,3,10
00b34d81,135005,137545,1,0,2540,3,10
0350deb7,135005,137905,7,3,2900,3,10
07513ae5,135005,138265,5,7,3260,3,10
07b22802,135005,138625,2,7,3620,3,10
0879a0b1,337015,337575,1,8,560,3,10
047be715,438015,438465,5,4,450,3,10
09241852,438055,438935,2,9,880,3,10
04c603b3,539085,539495,3,4,410,3,10
02535243,1055,1455,3,2,400,13,4
0295e813,12045,12485,0,2,440,13,4
024d6092,12095,12845,1,2,750,13,4
02056630,12195,13215,3,2,1020,13,4
02284650,12405,13575,0,2,1170,13,4
02f998d0,12345,13935,1,2,1590,13,4
02752123,12435,14305,3,2,1870,13,4
007cd0d2,23105,23525,2,0,420,13,4
03cdb8f2,23795,24345,2,3,550,13,4
02069f23,34015,34425,1,2,410,13,4
03696ce1,34025,34785,2,3,760,13,4
0007ae82,34045,35145,3,0,1100,13,4
02a4ec51,34055,35505,0,2,1450,13,4
006333a3,135005,135385,3,0,380,13,4
010f3781,135005,136465,1,1,1460,13,4
004569f0,135005,136825,0,0,1820,13,4
027d6532,135005,137185,2,2,2180,13,4
034b3412,135005,137545,2,3,2540,13,4
03bc05b0,337055,337435,0,3,380,13,4
02e37893,337115,338165,3,2,1050,13,4
037fc510,438035,438465,0,3,430,13,4
0112f963,438115,438855,3,1,740,13,4
0325a771,539285,540075,1,3,790,13,4
02535241,1065,1495,1,2,430,13,7
0595e811,12085,12465,6,5,380,13,7
05056630,12195,12875,3,5,680,13,7
0497b0d0,23045,23485,0,4,440,13,7
01284655,34025,34425,4,1,400,13,7
067cd0d1,34265,34855,2,6,590,13,7
03752125,34095,35575,4,3,1480,13,7
06457ed5,34475,35935,5,6,1460,13,7
053d2aa6,34795,36295,6,5,1500,13,7
01272770,34965,36655,0,1,1690,13,7
05724c64,34685,37015,1,5,2330,13,7
043f1761,34315,37375,2,4,3060,13,7
01df78c5,34565,37735,3,1,3170,13,7
068495c2,35445,38455,5,6,3010,13,7
05696ce2,35325,38815,6,5,3490,13,7
06e28bd4,35495,39175,0,6,3680,13,7
03cdb8f1,35155,39535,1,3,4380,13,7
0607ae82,35425,39905,3,6,4480,13,7
00a12894,135005,135385,4,0,380,13,7
013327e0,135005,135745,0,1,740,13,7
00e37893,135005,136105,3,0,1100,13,7
015816d6,135005,136465,6,1,1460,13,7
05ff29c5,135005,136825,5,5,1820,13,7
05726656,135005,137185,6,5,2180,13,7
0274a022,135005,137545,2,2,2540,13,7
06c603b6,135005,137905,6,6,2900,13,7
05d945c0,135005,138265,0,5,3260,13,7
06cdb120,135005,138625,0,6,3620,13,7
00f38862,135005,138985,2,0,3980,13,7
0191ae60,135005,139345,0,1,4340,13,7
04fdd6b1,135005,139705,1,4,4700,13,7
03b34d85,135005,140065,5,3,5060,13,7
05fcf0e0,337055,337495,0,5,440,13,7
02976674,438515,438895,4,2,380,13,7
039e94e6,438455,439265,6,3,810,13,7
03fb9b60,438585,439625,0,3,1040,13,7
05eed561,438375,439985,1,5,1610,13,7
00bc4b84,438705,440375,4,0,1670,13,7
04187791,438645,440785,1,4,2140,13,7
0565d931,539125,539635,1,5,510,13,7
00535241,1045,1475,1,0,430,9,5
0395e813,12095,12475,0,3,380,9,5
0397b0d2,12235,12835,1,3,600,9,5
034d6094,12185,13245,0,3,1060,9,5
02f998d3,23065,23525,3,2,460,9,5
003f1763,23375,23955,3,0,580,9,5
00457ed0,34095,34485,1,0,390,9,5
04dcd3d0,34065,34845,2,4,780,9,5
03784c50,34265,35565,4,3,1300,9,5
03df78c1,34115,35925,0,3,1810,9,5
03696ce1,34635,36285,1,3,1650,9,5
01a4ec50,34685,36645,2,1,1960,9,5
02ff7e54,34355,37365,4,2,3010,9,5
04069f23,34535,37725,0,4,3190,9,5
03572cf4,135005,135745,4,3,740,9,5
010f3784,135005,136105,4,1,1100,9,5
007be710,135005,136465,0,0,1460,9,5
01e28bd3,135005,136825,3,1,1820,9,5
034b3411,135005,137545,1,3,2540,9,5
02fdd2a1,135005,137905,1,2,2900,9,5
0199bf13,135005,138265,3,1,3260,9,5
01845aa4,135005,138625,4,1,3620,9,5
02d945c0,337365,338235,0,2,870,9,5
02da9f81,337165,338595,1,2,1430,9,5
01e37892,337475,338955,2,1,1480,9,5
01d60b73,337265,339315,3,1,2050,9,5
024569f1,337325,340045,1,2,2720,9,5
03ec0d72,438105,438485,2,3,380,9,5
012ed3d3,539365,539775,3,1,410,9,5
007edc81,539235,540165,1,0,930,9,5
05535248,1085,1475,8,5,390,13,12
0195e818,12075,12545,11,1,470,13,12
01056630,12215,12905,0,1,690,13,12
01f998d7,12405,13635,3,1,1230,13,12
01284656,12475,14005,5,1,1530,13,12
014d6095,12145,14365,6,1,2220,13,12
013e3015,12595,14725,7,1,2130,13,12
01752125,12575,15135,11,1,2560,13,12
01dcd3d5,12795,15875,3,1,3080,13,12
01457ed6,12895,16245,5,1,3350,13,12
01df78ca,12975,16605,6,1,3630,13,12
013f176a,12695,16965,7,1,4270,13,12
08de9f94,23025,23405,4,8,380,13,12
0a2d6124,23325,23975,4,10,650,13,12
04cdb8f4,34015,34465,7,4,450,13,12
018495c2,34355,34855,10,1,500,13,12
04696ce5,34185,35215,11,4,1030,13,12
0542120b,34685,35575,0,5,890,13,12
0aa4ec57,34255,35935,1,10,1680,13,12
05726659,34535,36295,2,5,1760,13,12
04069f21,34115,36655,3,4,2540,13,12
02ccc9d5,34825,37015,4,2,2190,13,12
0807ae83,34225,37375,5,8,3150,13,12
0362ad56,35125,37745,7,3,2620,13,12
03c380d0,35035,38115,9,3,3080,13,12
047d653b,35075,38475,10,4,3400,13,12
0974a026,35165,38835,11,9,3670,13,12
07f6263a,34575,39205,1,7,4630,13,12
0803e966,34915,39575,3,8,4660,13,12
09fdd6b2,35085,39935,4,9,4850,13,12
0a845aaa,34785,40295,5,10,5510,13,12
0133ed07,135005,135385,7,1,380,13,12
0528f1f7,135005,135745,7,5,740,13,12
01dbc262,135005,136105,2,1,1100,13,12
0436cda5,135005,136465,5,4,1460,13,12
0a102c38,135005,136825,8,10,1820,13,12
03b69db9,135005,137185,9,3,2180,13,12
0318d883,135005,137545,3,3,2540,13,12
00ea766a,135005,137905,10,0,2900,13,12
0161ab62,135005,138265,2,1,3260,13,12
08fe91d3,135005,138625,3,8,3620,13,12
0a265b66,135005,138985,6,10,3980,13,12
0999bf15,135005,139345,5,9,4340,13,12
065816d6,135005,139705,6,6,4700,13,12
02ebc9a7,135005,140785,7,2,5780,13,12
04f2c048,135005,141145,8,4,6140,13,12
04807691,135005,141505,1,4,6500,13,12
0a408da2,135005,141865,2,10,6860,13,12
06921c05,135005,142225,5,6,7220,13,12
08a12898,135005,142945,8,8,7940,13,12
0a3327e3,135005,143305,3,10,8300,13,12
04e37894,135005,143665,4,4,8660,13,12
09574c56,337065,337475,6,9,410,13,12
081b4983,337115,337985,3,8,870,13,12
0727b4b5,337185,338355,5,7,1170,13,12
080168a5,438115,438565,5,8,450,13,12
07efda91,438285,439055,1,7,770,13,12
0ab80a82,438235,439415,2,10,1180,13,12
028d14e3,438195,439775,3,2,1580,13,12
0aa1d2a3,539395,539845,3,10,450,13,12
0b466e64,539185,540205,4,11,1020,13,12
095f48d8,539435,540615,8,9,1180,13,12
0053524b,1045,1475,11,0,430,8,15
0905663e,12205,12625,3,9,420,8,15
094d6098,12185,13435,10,9,1250,8,15
0997b0dd,12285,13865,0,9,1580,8,15
09284652,12405,14735,10,9,2330,8,15
003e301a,23075,23465,10,0,390,8,15
05457eda,23375,24095,10,5,720,8,15
0dde9f9e,34115,34505,12,13,390,8,15
00df78cd,34055,34915,1,0,860,8,15
00724c62,34215,35285,3,0,1070,8,15
063d2aad,34375,35645,4,6,1270,8,15
0e272770,34545,36035,7,14,1490,8,15
05ff7e5e,34475,36425,10,5,1950,8,15
07cdb8f3,34655,36835,14,7,2180,8,15
0e2d6122,34585,37205,1,14,2620,8,15
0dc4bd98,135005,135385,8,13,380,8,15
09d945cc,135005,135745,12,9,740,8,15
0dd7f0c2,135005,136105,2,13,1100,8,15
009e7390,135005,136465,0,0,1460,8,15
03caf2a2,135005,136825,2,3,1820,8,15
05bb4a3e,135005,137185,14,5,2180,8,15
008db5a3,135005,137545,3,0,2540,8,15
071ff44d,135005,137905,13,7,2900,8,15
0a102c36,135005,138265,6,10,3260,8,15
0d696cea,135005,138625,10,13,3620,8,15
063870a3,135005,138985,3,6,3980,8,15
0d7d653a,135005,139345,10,13,4340,8,15
099650a6,135005,139705,6,9,4700,8,15
00a1289b,135005,140065,11,0,5060,8,15
017be717,135005,140425,7,1,5420,8,15
067fc513,135005,141145,3,6,6140,8,15
045007e3,135005,141505,3,4,6500,8,15
04b4b494,135005,141865,4,4,6860,8,15
0bdbc265,135005,142225,5,11,7220,8,15
01b36cb1,135005,142585,1,1,7580,8,15
03e94df9,135005,142945,9,3,7940,8,15
01ebc9ad,135005,143305,13,1,8300,8,15
0ae8a383,135005,143665,3,10,8660,8,15
0a72665e,135005,144025,14,10,9020,8,15
053b813b,135005,144385,11,5,9380,8,15
0a572cfa,135005,144745,10,10,9740,8,15
01b34d87,135005,145105,7,1,10100,8,15
00fdd2a4,135005,145465,4,0,10460,8,15
07a4b157,135005,145825,7,7,10820,8,15
0165d930,337045,337655,0,1,610,8,15
0bf2c043,337145,338045,3,11,900,8,15
057ca59b,337215,338535,11,5,1320,8,15
0ccde4d6,438085,438555,6,12,470,8,15
070b7d98,438165,438925,8,7,760,8,15
024266d3,438185,439455,3,2,1270,8,15
0c5e2768,539035,539545,8,12,510,8,15
0595e810,12095,12545,3,5,450,11,8
054d6091,12145,12905,4,5,760,11,8
0597b0d2,23055,23525,2,5,470,11,8
00457ed2,23315,24015,2,0,700,11,8
00df78c5,34075,34505,1,0,430,11,8
04784c57,34255,34865,2,4,610,11,8
01069f20,34545,35225,3,1,680,11,8
06de9f94,34145,35985,0,6,1840,11,8
05cdb8f5,34475,36345,1,5,1870,11,8
07272773,34365,36705,2,7,2340,11,8
022d6124,34445,37155,0,2,2710,11,8
05a4b157,135005,135745,7,5,740,11,8
04bc05b1,135005,136105,1,4,1100,11,8
042ed3d3,135005,136465,3,4,1460,11,8
052ae3f5,135005,136825,5,5,1820,11,8
04a4ec50,135005,137185,0,4,2180,11,8
0403e963,135005,137545,3,4,2540,11,8
069650a3,135005,137905,3,6,2900,11,8
006333a1,135005,138265,1,0,3260,11,8
024569f3,135005,138625,3,2,3620,11,8
027edc82,135005,138985,2,2,3980,11,8
07a595b0,135005,139345,0,7,4340,11,8
03bb4a37,135005,139705,7,3,4700,11,8
02572cf5,135005,140425,5,2,5420,11,8
0750deb4,135005,140785,4,7,5780,11,8
0690d440,337105,337515,0,6,410,11,8
048db5a1,337325,337875,1,4,550,11,8
0491ae63,337245,338245,3,4,1000,11,8
038565f5,337095,338615,5,3,1520,11,8
07b36cb5,337155,339435,5,7,2280,11,8
07ae2b55,438255,438705,5,7,450,11,8
0540cd06,438545,439065,6,5,520,11,8
03e94df1,438315,439455,1,3,1140,11,8
02119793,438345,439825,3,2,1480,11,8
0390b2a5,438635,440195,5,3,1560,11,8
051ff443,438445,440645,3,5,2200,11,8
046adab5,539035,539425,5,4,390,11,8
00eed563,539415,540035,3,0,620,11,8
041340a5,539625,540405,5,4,780,11,8
05535244,1095,1555,4,5,460,3,14
0995e819,12055,12645,8,9,590,3,14
09056633,12175,13055,12,9,880,3,14
094d6095,12125,13415,13,9,1290,3,14
0197b0d9,23105,23665,9,1,560,3,14
0bf998d9,23155,24275,9,11,1120,3,14
097cd0d7,34135,34875,3,9,740,3,14
0d3e3015,34105,35235,4,13,1130,3,14
003d2aa0,34565,35595,5,0,1030,3,14
04284658,34045,35955,6,4,1910,3,14
0adf78c5,34425,36315,7,10,1890,3,14
03784c53,34525,36675,8,3,2150,3,14
0cff7e57,34575,37395,10,12,2820,3,14
02b2280c,35605,37755,11,2,2150,3,14
083f1765,34205,38475,13,8,4270,3,14
08696cea,34935,38835,0,8,3900,3,14
04de9f91,34475,39195,1,4,4720,3,14
0c272776,34635,39555,2,12,4920,3,14
09724c6a,34495,39915,3,9,5420,3,14
058495c0,35165,40275,4,5,5110,3,14
0007ae88,35015,40635,5,0,5620,3,14
0b457edc,34365,40995,6,11,6630,3,14
0cfe91d4,36215,41355,7,12,5140,3,14
0303e96d,35815,41745,10,3,5930,3,14
04421202,35675,42105,11,4,6430,3,14
043b813b,35835,42465,12,4,6630,3,14
00c380d7,35915,42825,13,0,6910,3,14
062d6125,34725,43195,1,6,8470,3,14
05ccc9d2,35775,43915,3,5,8140,3,14
08b582dc,35345,44275,4,8,8930,3,14
02fdd6b5,35985,44635,5,2,8650,3,14
0d9a18f7,135005,135385,7,13,380,3,14
0d4569fa,135005,135745,10,13,740,3,14
05ec0d79,135005,136465,9,5,1460,3,14
03d7f0cb,135005,136825,11,3,1820,3,14
0b30aca6,135005,137185,6,11,2180,3,14
000f3785,135005,137905,5,0,2900,3,14
04265b6a,135005,138265,10,4,3260,3,14
03502bcb,135005,138625,11,3,3620,3,14
0b7be716,135005,138985,6,11,3980,3,14
03c603bd,135005,139345,13,3,4340,3,14
0aa4b15b,135005,139705,11,10,4700,3,14
0c307623,135005,140065,3,12,5060,3,14
0425a772,337045,337675,2,4,630,3,14
012ed3da,438035,438585,10,1,550,3,14
0c9e7393,539165,539575,3,12,410,3,14
06535243,1015,1415,3,6,400,5,10
074d6090,12155,12535,8,7,380,5,10
0795e817,12055,12925,1,7,870,5,10
03056635,23035,23465,5,3,430,5,10
0997b0d5,23135,23995,5,9,860,5,10
01284656,34025,34465,5,1,440,5,10
07752122,34035,34915,1,7,880,5,10
06de9f90,135005,135385,0,6,380,5,10
01272777,135005,135745,7,1,740,5,10
0507ae87,135005,136105,7,5,1100,5,10
03726656,135005,136465,6,3,1460,5,10
047d6539,135005,137185,9,4,2180,5,10
09fe91d3,135005,137545,3,9,2540,5,10
0714c3c8,135005,137905,8,7,2900,5,10
020f3783,135005,138265,3,2,3260,5,10
077cd0d2,135005,138625,2,7,3620,5,10
053d2aa2,135005,138985,2,5,3980,5,10
06069f23,135005,139345,3,6,4340,5,10
09e28bd6,135005,139705,6,9,4700,5,10
00b22803,135005,140065,3,0,5060,5,10
033b8130,135005,140425,0,3,5420,5,10
0274a027,135005,140785,7,2,5780,5,10
099650a2,135005,141145,2,9,6140,5,10
054b3416,135005,141505,6,5,6500,5,10
04265b62,135005,141865,2,4,6860,5,10
06457ed1,135005,142225,1,6,7220,5,10
06c603b0,337155,337555,0,6,400,5,10
05241851,337085,337915,1,5,830,5,10
097be712,337075,338275,2,9,1200,5,10
082554f3,337135,338635,3,8,1500,5,10
083327e6,438065,438515,6,8,450,5,10
046333a1,438045,438945,1,4,900,5,10
055fb4c2,539165,539555,2,5,390,5,10
08307623,539145,539915,3,8,770,5,10
0395e813,12035,12415,0,3,380,10,4
0397b0d0,12275,12775,1,3,500,10,4
03056630,12195,13135,2,3,940,10,4
03f998d0,12365,13855,0,3,1490,10,4
01752120,23045,23485,0,1,440,10,4
037cd0d3,34085,34485,0,3,400,10,4
00457ed2,34275,34845,1,0,570,10,4
013f1763,34125,35565,3,1,1440,10,4
03cdb8f1,34735,35925,0,3,1190,10,4
03272771,34685,36285,1,3,1600,10,4
012d6121,34715,36645,2,1,1930,10,4
00df78c0,34305,37005,3,0,2700,10,4
03696ce0,135005,135745,0,3,740,10,4
00421202,135005,136105,2,0,1100,10,4
0163eae0,135005,136465,0,1,1460,10,4
01fdd2a0,135005,136825,0,1,1820,10,4
02307620,337085,337515,0,2,430,10,4
031559f1,337205,337875,1,3,670,10,4
015fb4c2,337135,338235,2,1,1100,10,4
02bc05b3,337565,338595,3,2,1030,10,4
03e37890,337575,338955,0,3,1380,10,4
03d945c1,337495,339315,1,3,1820,10,4
00d60b72,337355,339675,2,0,2320,10,4
0333ed00,438055,438455,0,3,400,10,4
02e32491,438025,438815,1,2,790,10,4
03ec0d72,539025,539415,2,3,390,10,4
07535246,1005,1555,6,7,550,14,9
034d6090,12085,12545,5,3,460,14,9
0395e811,12075,12915,7,3,840,14,9
0397b0d6,12155,13285,0,3,1130,14,9
03284652,12245,13645,1,3,1400,14,9
03056635,12125,14005,2,3,1880,14,9
03f998d3,12195,14375,4,3,2180,14,9
03752124,12265,14735,5,3,2470,14,9
033e3016,12305,15145,0,3,2840,14,9
007cd0d4,23095,23525,4,0,430,14,9
00df78c4,23335,24035,4,0,700,14,9
00de9f96,34015,34465,1,0,450,14,9
00784c58,34095,35195,4,0,1100,14,9
01b582d1,34685,35555,5,1,870,14,9
08724c60,34055,35925,7,8,1870,14,9
048495c3,34515,36285,8,4,1770,14,9
06ff7e52,34155,36645,0,6,2490,14,9
0707ae80,34385,37005,1,7,2620,14,9
06e28bd0,34615,37785,7,6,3170,14,9
078565f3,135005,135385,3,7,380,14,9
0540cd00,135005,135745,0,5,740,14,9
06187796,135005,136105,6,6,1100,14,9
04fe91d0,135005,136825,0,4,1820,14,9
01307623,135005,137545,3,1,2540,14,9
0112f962,135005,137905,2,1,2900,14,9
08a595b5,135005,138265,5,8,3260,14,9
03119790,135005,138625,0,3,3620,14,9
01fb9b67,135005,138985,7,1,3980,14,9
0672db66,135005,139345,6,6,4340,14,9
0874a022,135005,139705,2,8,4700,14,9
0450deb3,135005,140065,3,4,5060,14,9
0799bf16,135005,140425,6,7,5420,14,9
00ec0d76,135005,140785,6,0,5780,14,9
0192f850,135005,141145,0,1,6140,14,9
089a82f0,135005,141505,0,8,6500,14,9
03c9c2e0,337455,338215,0,3,760,14,9
0418d881,337165,338575,1,4,1410,14,9
01530c73,337365,338945,3,1,1580,14,9
057e4084,337505,339305,4,5,1800,14,9
030042d5,337325,339665,5,3,2340,14,9
017a6fd8,337605,340055,8,1,2450,14,9
041451c0,337515,340415,0,4,2900,14,9
01567862,438115,438505,2,1,390,14,9
07ea7663,438205,438865,3,7,660,14,9
05408da4,438135,439225,4,5,1090,14,9
015c4708,539025,539425,8,1,400,14,9
03761374,539425,540005,4,3,580,14,9
0659f265,539575,540365,5,6,790,14,9
00535246,1075,1575,6,0,500,3,11
0595e816,12045,12425,9,5,380,3,11
054d6097,12135,12875,4,5,740,3,11
03056637,23085,23605,7,3,520,3,11
0597b0d7,34105,34525,3,5,420,3,11
003f1762,34505,34935,7,0,430,3,11
05f998da,34145,35325,10,5,1180,3,11
06284656,34225,35685,0,6,1460,3,11
0a752128,34265,36045,1,10,1780,3,11
07cdb8f2,35215,36405,2,7,1190,3,11
02df78c8,34715,36765,3,2,2050,3,11
08457ed4,34675,37125,4,8,2450,3,11
02069f22,35275,37485,5,2,2210,3,11
00dcd3d7,34595,37845,6,0,3250,3,11
07272775,35145,38215,8,7,3070,3,11
0407ae88,35335,38575,9,4,3240,3,11
05de9f9a,34765,38935,10,5,4170,3,11
09696ce4,35305,39295,0,9,3990,3,11
093e3013,34345,39655,1,9,5310,3,11
0a2d6120,35155,40045,4,10,4890,3,11
02e28bd2,35575,40415,6,2,4840,3,11
00a4ec5a,35415,40805,9,0,5390,3,11
008bdf2a,135005,135385,10,0,380,3,11
06b34d88,135005,135745,8,6,740,3,11
04513ae2,135005,136465,2,4,1460,3,11
05726655,135005,136825,5,5,1820,3,11
04b2280a,135005,137185,10,4,2180,3,11
06ccc9d5,135005,137545,5,6,2540,3,11
08c380d2,135005,137905,2,8,2900,3,11
0962ad57,135005,138265,7,9,3260,3,11
09fe91d5,135005,138625,5,9,3620,3,11
019650a7,135005,138985,7,1,3980,3,11
082554f0,337055,337575,0,8,520,3,11
04c603b3,438095,438505,3,4,410,3,11
086333a4,438195,438865,4,8,670,3,11
0299bf17,539275,539765,7,2,490,3,11
01535240,1075,1475,0,1,400,3,4
01056631,12105,12785,2,1,680,3,4
0097b0d3,23095,23475,3,0,380,3,4
00284653,23265,23885,3,0,620,3,4
03dcd3d0,34245,34825,0,3,580,3,4
023f1761,34235,35185,1,2,950,3,4
013e3013,34135,35545,2,1,1410,3,4
03cdb8f3,34805,36625,1,3,1820,3,4
00069f23,34905,36985,2,0,2080,3,4
01fdd6b0,135005,135385,0,1,380,3,4
013870a3,135005,135745,3,1,740,3,4
033b8132,135005,136465,2,3,1460,3,4
01572cf0,337105,337515,0,1,410,3,4
009650a1,438155,438875,1,0,720,3,4
0030aca2,539095,539485,2,0,390,3,4
04284650,12355,12805,0,4,450,15,5
0497b0d0,12265,13165,1,4,900,15,5
04056630,12175,13525,2,4,1350,15,5
04457ed4,12655,14255,0,4,1600,15,5
043e3011,12425,14615,1,4,2190,15,5
047cd0d2,12445,14975,2,4,2530,15,5
03df78c4,23065,23445,4,3,380,15,5
032d6124,23435,23875,4,3,440,15,5
04421203,34395,34825,1,4,430,15,5
043870a4,34275,35185,2,4,910,15,5
00b22801,34375,35545,3,0,1170,15,5
02726650,34215,35905,4,2,1690,15,5
02b582d0,34165,36265,0,2,2100,15,5
0230aca2,35355,37345,3,2,1990,15,5
0063eae2,35075,37705,4,0,2630,15,5
04502bc2,36085,38065,0,4,1980,15,5
041559f2,36855,38785,2,4,1930,15,5
00d60b71,36935,39145,3,0,2210,15,5
00bc05b3,37095,39505,4,0,2410,15,5
04e37894,37125,40225,1,4,3100,15,5
0492f851,135005,135385,1,4,380,15,5
04292b34,135005,135745,4,4,740,15,5
0140cd03,135005,136105,3,1,1100,15,5
01bc4b81,135005,136465,1,1,1460,15,5
03bb4a30,135005,137185,0,3,2180,15,5
04e8a381,135005,137905,1,4,2900,15,5
0371a463,135005,138265,3,3,3260,15,5
0128f1f2,135005,138625,2,1,3620,15,5
04e07292,337085,337495,2,4,410,15,5
047901c3,337125,337855,3,4,730,15,5
035c4704,337375,338215,4,3,840,15,5
047c63d0,337215,338575,0,4,1360,15,5
01408da2,337165,338945,2,1,1780,15,5
02761373,337765,339305,3,2,1540,15,5
004f61a4,337705,339665,4,0,1960,15,5
01ab35e0,337525,340025,0,1,2500,15,5
01000b92,337755,340395,2,1,2640,15,5
009837d2,438255,438735,2,0,480,15,5
01f0fdc3,438345,439095,3,1,750,15,5
003b6cf4,438565,439455,4,0,890,15,5
01a9b7e0,438465,439815,0,1,1350,15,5
03157861,438395,440175,1,3,1780,15,5
00d2b792,438615,440535,2,0,1920,15,5
023ff781,438445,440945,1,2,2500,15,5
008e4fa2,539015,539405,2,0,390,15,5
00a8a294,539415,539935,4,0,520,15,5
02175c11,539505,540305,1,2,800,15,5
0b535244,1095,1715,4,11,620,12,16
0b95e81b,12015,12445,6,11,430,12,16
0b284651,12295,12855,10,11,560,12,16
0b4d6096,12065,13225,12,11,1160,12,16
0bf998d9,12265,13585,13,11,1320,12,16
0b05663a,12135,13995,1,11,1860,12,16
0b752127,12355,14355,2,11,2000,12,16
0b97b0d9,12205,14725,4,11,2520,12,16
0b3e301b,12415,15085,5,11,2670,12,16
0b7cd0d4,12485,15735,5,11,3250,12,16
0f3f1769,23065,23505,9,15,440,12,16
08dcd3d9,23135,24155,9,8,1020,12,16
02df78c7,34055,34585,13,2,530,12,16
0b696ce4,34535,34945,14,11,410,12,16
0c457edc,34045,35305,15,12,1260,12,16
083d2aa0,34275,35665,0,8,1390,12,16
0ede9f9a,34135,36035,2,14,1900,12,16
0c784c55,34245,36405,4,12,2160,12,16
0c2d6129,34405,36775,6,12,2370,12,16
08ff7e5c,34325,37185,10,8,2860,12,16
00272774,34385,37545,11,0,3160,12,16
00724c64,34175,37915,13,0,3740,12,16
09069f29,34505,38345,2,9,3840,12,16
0fcdb8f4,34485,38715,4,15,4230,12,16
0ffdd2a2,135005,135385,2,15,380,12,16
0f5fb4cf,135005,135745,15,15,740,12,16
0d7fc513,135005,136105,3,13,1100,12,16
0abf6d36,135005,136465,6,10,1460,12,16
05dbc26a,135005,136825,10,5,1820,12,16
062e2edf,135005,137185,15,6,2180,12,16
0cebc9a4,135005,137545,4,12,2540,12,16
0b65d930,135005,137905,0,11,2900,12,16
0649b047,135005,138265,7,6,3260,12,16
03e0729a,135005,138625,10,3,3620,12,16
014f61a3,135005,138985,3,1,3980,12,16
01d80db7,135005,139345,7,1,4340,12,16
0da4ec54,135005,140065,4,13,5060,12,16
033b8132,135005,140425,2,3,5420,12,16
0314c3c1,135005,140785,1,3,5780,12,16
05c4bd9b,135005,141145,11,5,6140,12,16
0a33ed05,135005,141505,5,10,6500,12,16
039e739b,135005,141865,11,3,6860,12,16
0eff29c7,135005,142225,7,14,7220,12,16
008db5ad,135005,142585,13,0,7580,12,16
03fcf0e2,135005,142945,2,3,7940,12,16
0bbc4b80,135005,143305,0,11,8300,12,16
0f37195d,135005,143665,13,15,8660,12,16
0a1451c9,135005,144025,9,10,9020,12,16
0b779fa2,135005,144385,2,11,9380,12,16
073ff78b,135005,144745,11,7,9740,12,16
07488356,135005,145105,6,7,10100,12,16
04a8ca16,135005,145465,6,4,10460,12,16
0eccc9db,135005,145825,11,14,10820,12,16
0e9650ab,135005,146185,11,14,11180,12,16
0a513aef,135005,146545,15,10,11540,12,16
07fb52a3,337045,337425,3,7,380,12,16
09a1d2a4,337065,337785,4,9,720,12,16
0dde638b,337205,338585,11,13,1380,12,16
0d5ff9ec,337195,338945,12,13,1750,12,16
005f48d4,337125,339435,4,0,2310,12,16
05345ca3,438155,438535,3,5,380,12,16
0e4e3c8b,438105,439025,11,14,920,12,16
007aec7b,539135,539545,11,0,410,12,16
08b3b7f2,539555,539945,2,8,390,12,16
04535242,1015,1475,2,4,460,5,6
0195e815,12045,12445,0,1,400,5,6
01056630,12165,13195,4,1,1030,5,6
047cd0d0,23365,23905,0,4,540,5,6
053f1764,34095,34485,2,5,390,5,6
04dcd3d5,34135,34845,3,4,710,5,6
05724c65,34285,35205,4,5,920,5,6
00784c55,34385,35565,5,0,1180,5,6
052d6122,34625,35925,0,5,1300,5,6
013d2aa1,34475,36295,2,1,1820,5,6
00272771,34595,36655,3,0,2060,5,6
02696ce2,34755,37025,5,2,2270,5,6
01069f23,34735,37385,0,1,2650,5,6
01fdd6b4,135005,135385,4,1,380,5,6
02572cf5,135005,135745,5,2,740,5,6
008bdf23,135005,136105,3,0,1100,5,6
05ccc9d1,135005,137185,1,5,2180,5,6
0263eae2,135005,137545,2,2,2540,5,6
0130aca0,135005,137905,0,1,2900,5,6
02b34d84,135005,138265,4,2,3260,5,6
02b582d3,135005,138625,3,2,3620,5,6
03421205,135005,138985,5,3,3980,5,6
04265b63,337085,337535,3,4,450,5,6
00513ae4,337265,337895,4,0,630,5,6
05bf9c61,337175,338285,1,5,1110,5,6
01502bc4,337365,338675,4,1,1310,5,6
0279a0b3,438045,438455,3,2,410,5,6
01241850,438125,439185,0,1,1060,5,6
057be713,438095,439575,3,5,1480,5,6
016333a5,539175,539665,5,1,490,5,6
043327e0,539215,540025,0,4,810,5,6
05535240,1015,1475,0,5,460,8,14
0595e81c,12055,12485,0,5,430,8,14
0505663b,12195,12935,6,5,740,8,14
054d609d,12125,13305,8,5,1180,8,14
05f998d7,12365,13665,9,5,1300,8,14
0597b0d9,12265,14075,13,5,1810,8,14
0728465a,23025,23405,10,7,380,8,14
09457eda,23385,24015,10,9,630,8,14
03de9f92,34095,34485,0,3,390,8,14
06724c62,34155,34855,2,6,700,8,14
0a3d2aa9,34285,35215,3,10,930,8,14
01ff7e52,34315,35575,4,1,1260,8,14
0be28bd7,34765,35935,5,11,1170,8,14
07726655,34885,36295,6,7,1410,8,14
0b784c57,34245,36655,7,11,2410,8,14
05272777,34365,37015,8,5,2650,8,14
04845aa2,35205,37375,9,4,2170,8,14
042d6126,34385,37735,10,4,3350,8,14
01b22802,35075,38095,11,1,3020,8,14
09069f25,34515,38455,12,9,3940,8,14
00696ce5,34595,38815,13,0,4220,8,14
017d653a,35495,39175,0,1,3680,8,14
0cf6263b,34965,39535,1,12,4570,8,14
04b582dd,34795,39895,2,4,5100,8,14
0bfdd6b0,35585,40255,3,11,4670,8,14
0d63eae4,35785,40625,5,13,4840,8,14
08572cfb,35965,40985,6,8,5020,8,14
01449231,36005,41345,7,1,5340,8,14
06c380d1,35455,41705,8,6,6250,8,14
01fe91dd,35885,42065,9,1,6180,8,14
060f3781,36585,42425,10,6,5840,8,14
05b34d81,36565,42835,0,5,6270,8,14
0614c3cd,36265,43195,1,6,6930,8,14
0b62ad5a,35635,43555,2,11,7920,8,14
0de618a1,36395,43915,3,13,7520,8,14
029650ac,36095,44285,5,2,8190,8,14
0a4b3418,36485,44645,6,10,8160,8,14
0840cd0b,135005,135385,11,8,380,8,14
07eed568,135005,135745,8,7,740,8,14
0c4bf942,135005,136105,2,12,1100,8,14
075e2767,135005,136465,7,7,1460,8,14
04ebab41,135005,136825,1,4,1820,8,14
0a241857,135005,137545,7,10,2540,8,14
0a307623,135005,137905,3,10,2900,8,14
07bc05b8,135005,138265,8,7,3260,8,14
00ccec28,135005,138625,8,0,3620,8,14
0228f1f9,135005,138985,9,2,3980,8,14
02563585,135005,139345,5,2,4340,8,14
0a9a82fa,135005,139705,10,10,4700,8,14
02fc1299,135005,140065,9,2,5060,8,14
06f72fd7,135005,140425,7,6,5420,8,14
0518779c,135005,140785,12,5,5780,8,14
090b7d94,135005,141145,4,9,6140,8,14
097e408c,135005,141865,12,9,6860,8,14
0479a0b0,135005,142225,0,4,7220,8,14
0899bf15,135005,142585,5,8,7580,8,14
064569f5,135005,142945,5,6,7940,8,14
0a12f96a,135005,143305,10,10,8300,8,14
015816d7,135005,143665,7,1,8660,8,14
082ae3f7,135005,144025,7,8,9020,8,14
0961773d,135005,144385,13,9,9380,8,14
0691ae64,135005,144745,4,6,9740,8,14
00119797,135005,145105,7,0,10100,8,14
0d408da9,337065,337535,9,13,470,8,14
097c63dc,337165,337925,12,9,760,8,14
08ab35e0,337355,338295,0,8,940,8,14
00199ba1,337335,338655,1,0,1320,8,14
02504735,337305,339405,5,2,2100,8,14
04779fa7,337405,339775,7,4,2370,8,14
0bea7669,337195,340145,9,11,2950,8,14
084f61a5,438205,438655,5,8,450,8,14
0b000b99,438255,439065,9,11,810,8,14
07761370,438345,439495,0,7,1150,8,14
02f0fdc4,539145,539575,4,2,430,8,14
07535241,1035,1575,1,7,540,14,12
08056631,12175,12555,11,8,380,14,12
08752123,12415,12915,0,8,500,14,12
0895e81a,12065,13305,3,8,1240,14,12
083e3016,12445,13695,6,8,1250,14,12
08f998d7,12355,14055,7,8,1700,14,12
087cd0d2,12475,14805,11,8,2330,14,12
08457ed6,12595,15165,0,8,2570,14,12
0897b0d8,12265,15555,3,8,3290,14,12
08dcd3d5,12575,15945,6,8,3370,14,12
03df78c4,23075,23645,4,3,570,14,12
01696ce4,23585,24215,4,1,630,14,12
018495c6,34205,34625,3,1,420,14,12
00f62632,34355,34985,4,0,630,14,12
0ab582d1,34275,35355,6,10,1080,14,12
0aa4ec58,34105,35715,7,10,1610,14,12
02e28bdb,34255,36085,9,2,1830,14,12
0972665a,34285,36455,11,9,2170,14,12
0b3870a9,34365,36825,1,11,2460,14,12
069a18f8,135005,135385,8,6,380,14,12
0b7edc80,135005,135745,0,11,740,14,12
0acaf2a9,135005,136105,9,10,1100,14,12
09b36cb6,135005,136465,6,9,1460,14,12
05fcf0e3,135005,136825,3,5,1820,14,12
0165d932,135005,137185,2,1,2180,14,12
04807693,135005,137545,3,4,2540,14,12
0b7c63d4,135005,137905,4,11,2900,14,12
0961ab63,135005,138265,3,9,3260,14,12
0742120b,135005,138625,11,7,3620,14,12
039650a9,135005,138985,9,3,3980,14,12
06fdd2a8,135005,139345,8,6,4340,14,12
05d7f0c4,135005,139705,4,5,4700,14,12
02b4b496,135005,140065,6,2,5060,14,12
0b90b2a0,135005,140785,0,11,5780,14,12
00bc4b87,135005,141145,7,0,6140,14,12
0049b04a,135005,141505,10,0,6500,14,12
01567862,135005,141865,2,1,6860,14,12
05921c00,135005,142225,0,5,7220,14,12
07578a11,135005,142585,1,7,7580,14,12
01572cf5,135005,142945,5,1,7940,14,12
07513ae2,135005,143305,2,7,8300,14,12
055fb4c8,135005,143665,8,5,8660,14,12
062e6ec8,337075,337515,8,6,440,14,12
00efda99,337365,337875,9,0,510,14,12
030168ab,337165,338245,11,3,1080,14,12
07bb90e1,337525,338615,1,7,1090,14,12
04b80a82,337265,338975,2,4,1710,14,12
038d14e4,337215,339345,4,3,2130,14,12
0a6c09f5,337585,339705,5,10,2120,14,12
00a8ca18,337435,340095,8,0,2660,14,12
07fb52a2,337605,340545,2,7,2940,14,12
02466e68,337555,340995,8,2,3440,14,12
014e3c84,438335,438775,4,1,440,14,12
0bfa8797,438235,439165,7,11,930,14,12
0459dba8,438705,439525,8,4,820,14,12
0a345ca9,438425,439885,9,10,1460,14,12
0abddb6b,438625,440255,11,10,1630,14,12
04f41130,438475,440615,0,4,2140,14,12
027aec77,438555,441085,7,2,2530,14,12
010c96b0,438515,441515,0,1,3000,14,12
036abc48,539055,539485,8,3,430,14,12
0ab3b7f8,539245,539995,8,10,750,14,12
02df5fa9,539315,540355,9,2,1040,14,12
01e5ebda,539475,540715,10,1,1240,14,12
0369ab4b,539185,541075,11,3,1890,14,12
0a535240,1065,1475,0,10,410,14,14
0295e811,12075,12505,1,2,430,14,14
02284656,12345,13225,3,2,880,14,14
027cd0d5,12545,13585,4,2,1040,14,14
023e3013,12445,13975,7,2,1530,14,14
0297b0d8,12245,14335,8,2,2090,14,14
024d6093,12145,14705,10,2,2560,14,14
0205663c,12165,15115,0,2,2950,14,14
02f998da,12275,15475,1,2,3200,14,14
023f1769,23055,23665,9,2,610,14,14
062d6129,23635,24275,9,6,640,14,14
04069f29,23775,24885,9,4,1110,14,14
08696ceb,34105,34545,3,8,440,14,14
088495c4,34245,34935,6,8,690,14,14
02a4ec5b,34215,35305,8,2,1090,14,14
0c07ae85,34125,35665,9,12,1540,14,14
0de28bdc,34275,36025,10,13,1750,14,14
08845aa5,34715,36385,11,8,1670,14,14
08b582d4,34365,36745,12,8,2380,14,14
0603e96a,34875,37105,13,6,2230,14,14
06f62630,34455,37825,1,6,3370,14,14
0663eae4,35245,38185,2,6,2940,14,14
05ccc9d7,34805,38545,3,5,3740,14,14
0cc380d6,34955,39265,5,12,4310,14,14
08fe91d7,35285,39635,7,8,4350,14,14
0b42120c,34665,40025,10,11,5360,14,14
0c9650a2,35535,40385,11,12,4850,14,14
053b8130,34885,40745,12,5,5860,14,14
07e618ad,35685,41105,13,7,5420,14,14
08572cfa,35385,41825,1,8,6440,14,14
018bdf23,35635,42235,5,1,6600,14,14
0130aca7,35565,42605,7,1,7040,14,14
0b779fa6,135005,135385,6,11,380,14,14
04d80db2,135005,135745,2,4,740,14,14
031b4981,135005,136105,1,3,1100,14,14
035f48da,135005,136465,10,3,1460,14,14
0069ab48,135005,136825,8,0,1820,14,14
07b34d86,135005,137185,6,7,2180,14,14
0d6333a4,135005,137545,4,13,2540,14,14
009e7395,135005,138265,5,0,3260,14,14
09dbc26b,135005,138625,11,9,3620,14,14
0bfb665c,135005,138985,12,11,3980,14,14
079e94e4,135005,139345,4,7,4340,14,14
0c4266d7,135005,139705,7,12,4700,14,14
07c9c2e9,135005,140065,9,7,5060,14,14
05175c19,135005,140785,9,5,5780,14,14
0cfb52a5,135005,141145,5,12,6140,14,14
0b295b9a,135005,141505,10,11,6500,14,14
065a98ec,135005,141865,12,6,6860,14,14
082554fb,135005,142225,11,8,7220,14,14
05d945cb,135005,142585,11,5,7580,14,14
0c5007e4,135005,142945,4,12,7940,14,14
08ff29c7,135005,143305,7,8,8300,14,14
032e2ed0,135005,143665,0,3,8660,14,14
06102c3a,135005,144025,10,6,9020,14,14
0bcde4d0,135005,144385,0,11,9380,14,14
060042d8,135005,144745,8,6,9740,14,14
09199ba3,135005,145105,3,9,10100,14,14
034e02d9,337075,337535,9,3,460,14,14
0c75f4b1,337155,338325,1,12,1170,14,14
0d9b0c28,337255,338795,8,13,1540,14,14
089fdeca,337415,339165,10,8,1750,14,14
04cf61e8,337305,339735,8,4,2430,14,14
00e1bd1b,438145,438715,11,0,570,14,14
01024410,438295,439105,0,1,810,14,14
0061c863,438195,439495,3,0,1300,14,14
0a4f9d87,539105,539625,7,10,520,14,14
085dca19,539755,540285,9,8,530,14,14
0d344b80,539675,540715,0,13,1040,14,14
02535246,1045,1575,6,2,530,8,11
0095e813,12055,12445,10,0,390,8,11
00056632,12125,13275,7,0,1150,8,11
00f998d0,12235,13635,8,0,1400,8,11
0097b0d3,12145,14005,10,0,1860,8,11
0328465a,23055,23445,10,3,390,8,11
013e3011,34065,34445,10,1,380,8,11
077cd0d3,34075,34875,4,7,800,8,11
04724c67,34335,35235,5,4,900,8,11
003f1768,34105,35605,7,0,1500,8,11
06752120,34045,35965,8,6,1920,8,11
062d6120,34705,36325,9,6,1620,8,11
07457ed4,34185,36685,10,7,2500,8,11
033d2aa8,34525,37075,2,3,2550,8,11
04cdb8f4,34765,37435,3,4,2670,8,11
03272772,34665,37795,4,3,3130,8,11
05069f2a,34835,38185,7,5,3350,8,11
00ff7e50,34615,38545,8,0,3930,8,11
0307ae89,34905,38905,9,3,4000,8,11
06696ce3,34895,39335,3,6,4440,8,11
01a4ec50,34915,39695,4,1,4780,8,11
052ed3d9,135005,135745,9,5,740,8,11
02488784,135005,136105,4,2,1100,8,11
08e28bd0,135005,136825,0,8,1820,8,11
07ccc9d8,135005,137185,8,7,2180,8,11
0a63eae5,135005,137545,5,10,2540,8,11
05e618a5,135005,137905,5,5,2900,8,11
0a513ae3,135005,138265,3,10,3260,8,11
006333a4,135005,138625,4,0,3620,8,11
089a18f0,135005,138985,0,8,3980,8,11
087edc81,135005,139345,1,8,4340,8,11
05bf6d34,135005,139705,4,5,4700,8,11
08f38863,135005,140065,3,8,5060,8,11
07292b39,135005,140425,9,7,5420,8,11
0962ad55,135005,141145,5,9,6140,8,11
0114c3c1,135005,141505,1,1,6500,8,11
09265b61,135005,141865,1,9,6860,8,11
052554f6,135005,142225,6,5,7220,8,11
025fb4c8,135005,142585,8,2,7580,8,11
06ae2b5a,337165,337555,10,6,390,8,11
00e94df1,337255,337925,1,0,670,8,11
0336cda2,337085,338285,2,3,1200,8,11
0440cd08,438145,438655,8,4,510,8,11
0590b2aa,438175,439025,10,5,850,8,11
086adab0,438205,439385,0,8,1180,8,11
00fcf0e2,438235,440105,2,0,1870,8,11
04102c31,539225,539815,1,4,590,8,11
0c535247,1065,1615,7,12,550,1,14
0595e818,12095,12665,9,5,570,1,14
074d6092,23075,23525,2,7,450,1,14
0d056633,34035,34985,8,13,950,1,14
0d784c50,34755,35355,10,13,600,1,14
0a3e3011,34385,35715,11,10,1330,1,14
043f1768,34415,36075,12,4,1660,1,14
05f998d6,34145,36795,0,5,2650,1,14
08457edc,34535,37155,1,8,2620,1,14
0c7cd0dd,34405,37515,2,12,3110,1,14
00df78c6,34545,37875,3,0,3330,1,14
02752125,34345,38235,4,2,3890,1,14
0228465a,34245,38595,5,2,4350,1,14
003d2aa1,34785,38955,6,0,4170,1,14
0d056633,34035,39325,8,13,5290,1,14
043f1768,34415,39735,12,4,5320,1,14
0c7cd0dd,34405,40145,2,12,5740,1,14
00df78c6,34545,40505,3,0,5960,1,14
053870a8,135005,135385,8,5,380,1,14
05b22804,135005,135745,4,5,740,1,14
0342120c,135005,136105,12,3,1100,1,14
06845aa7,135005,136465,7,6,1460,1,14
04ccc9da,135005,136825,10,4,1820,1,14
0d069f23,135005,137185,3,13,2180,1,14
03696ce2,135005,137545,2,3,2540,1,14
0c07ae87,135005,137905,7,12,2900,1,14
08a4ec50,135005,138265,0,8,3260,1,14
098495c9,135005,138625,9,9,3620,1,14
01e28bd5,135005,138985,5,1,3980,1,14
0bb582d6,135005,139345,6,11,4340,1,14
08726651,135005,139705,1,8,4700,1,14
0df6263c,135005,140065,12,13,5060,1,14
073b8134,337045,337435,4,7,390,1,14
0dc380d8,539085,539595,8,13,510,1,14
0753524f,1065,1615,15,7,550,13,16
0d95e812,12075,12505,9,13,430,13,16
0d4d6092,12175,12895,12,13,720,13,16
0e056634,23075,23725,4,14,650,13,16
0cf998d4,23215,24375,4,12,1160,13,16
0f284651,34035,34505,9,15,470,13,16
0c3d2aa9,34545,35225,11,12,680,13,16
05724c63,34495,35595,13,5,1100,13,16
05752121,34095,35955,14,5,1860,13,16
017cd0d6,34235,36315,15,1,2080,13,16
09ff7e51,34555,36675,0,9,2120,13,16
06de9f9b,34455,37035,1,6,2580,13,16
02fdd6be,35715,37755,3,2,2040,13,16
02784c57,34505,38115,4,2,3610,13,16
0fdcd3de,34395,38475,5,15,4080,13,16
0fcdb8f1,34675,38835,6,15,4160,13,16
037d6537,35705,39195,7,3,3490,13,16
0ee28bd0,35035,39555,8,14,4520,13,16
02457ed2,34425,39915,9,2,5490,13,16
012d612e,34615,40275,10,1,5660,13,16
06069f26,34775,40635,11,6,5860,13,16
05c380dd,35615,40995,12,5,5380,13,16
04f6263a,35175,41355,13,4,6180,13,16
019650ae,36025,42435,0,1,6410,13,16
0fb34d80,36425,43155,2,15,6730,13,16
0b2554f9,37065,43515,3,11,6450,13,16
05fdd2a7,36905,43875,4,5,6970,13,16
01c603b7,37155,44235,5,1,7080,13,16
01a1289d,36595,44625,8,1,8030,13,16
016333a2,37245,44985,9,1,7740,13,16
09502bcc,36865,45345,10,9,8480,13,16
0d14c3c5,36135,45705,11,13,9570,13,16
0f50deb3,36675,46065,12,15,9390,13,16
02513ae0,36835,46425,13,2,9590,13,16
09bf9c6a,36795,46815,0,9,10020,13,16
0c599fae,135005,135385,14,12,380,13,16
0f2e2ed5,135005,135745,5,15,740,13,16
0bf72fd0,135005,136105,0,11,1100,13,16
077ca59a,135005,136465,10,7,1460,13,16
0aebab43,135005,136825,3,10,1820,13,16
037c63d4,135005,137185,4,3,2180,13,16
0859f26e,135005,137545,14,8,2540,13,16
00578a17,135005,137905,7,0,2900,13,16
098d14ec,135005,138265,12,9,3260,13,16
0e4e3c86,135005,138625,6,14,3620,13,16
08df5faf,135005,138985,15,8,3980,13,16
0383dc93,135005,139345,3,3,4340,13,16
04cf61ea,135005,139705,10,4,4700,13,16
08a4b15d,135005,140065,13,8,5060,13,16
00e32497,135005,140425,7,0,5420,13,16
069e739a,135005,140785,10,6,5780,13,16
098db5a3,135005,141145,3,9,6140,13,16
09daddc8,135005,141505,8,9,6500,13,16
0465d937,135005,141865,7,4,6860,13,16
01261f74,135005,142225,4,1,7220,13,16
0c567864,135005,142585,4,12,7580,13,16
06737965,135005,142945,5,6,7940,13,16
02cee613,135005,143305,3,2,8300,13,16
062e6ecf,135005,143665,15,6,8660,13,16
05de638e,135005,144025,14,5,9020,13,16
0fb3b7fc,135005,144385,12,15,9380,13,16
0751e0b2,135005,144745,2,7,9740,13,16
0c75f4b4,135005,145105,4,12,10100,13,16
01c225b7,135005,145465,7,1,10460,13,16
09bc05b8,135005,145825,8,9,10820,13,16
005007e3,135005,146185,3,0,11180,13,16
0aa0c8e7,135005,146545,7,10,11540,13,16
06e4d122,337195,338045,2,6,850,13,16
0490f2b5,539305,539875,5,4,570,13,16
09b85c88,539425,540265,8,9,840,13,16
03535240,1005,1435,0,3,430,13,9
01056630,12155,12885,5,1,730,13,9
0197b0d3,12195,13245,6,1,1050,13,9
0195e812,12065,13605,7,1,1540,13,9
013f1768,12385,13965,8,1,1580,13,9
017cd0d4,12325,14325,0,1,2000,13,9
01dcd3d1,12445,15115,6,1,2670,13,9
013e3014,12295,15475,7,1,3180,13,9
05272774,23405,24035,4,5,630,13,9
082d6127,34025,34545,5,8,520,13,9
06069f20,34085,34915,7,6,830,13,9
00696ce6,34165,35275,8,0,1110,13,9
05b582d2,34455,35635,0,5,1180,13,9
04fdd6b5,34965,36005,2,4,1040,13,9
07a4ec55,34335,36365,3,7,2030,13,9
028495c3,34365,36725,4,2,2360,13,9
04f62634,34555,37085,5,4,2530,13,9
08ccc9d6,34765,37445,6,8,2680,13,9
05c380d7,34925,37805,7,5,2880,13,9
0163eae4,35115,38525,0,1,3410,13,9
080f3785,35655,38885,1,8,3230,13,9
0450deb8,35725,39245,2,4,3520,13,9
01241854,36135,39605,3,1,3470,13,9
088bdf22,35475,39975,5,8,4500,13,9
07bf9c62,35885,40335,6,7,4450,13,9
08fdd2a8,36035,40695,7,8,4660,13,9
0230aca0,35355,41055,8,2,5700,13,9
04c603b3,36235,41415,0,4,5180,13,9
052554f4,36205,41775,1,5,5570,13,9
0579a0b1,36045,42135,2,5,6090,13,9
08807693,135005,135745,3,8,740,13,9
01408da0,135005,136105,0,1,1100,13,9
04e37890,135005,136825,0,4,1820,13,9
055816d0,135005,137185,0,5,2180,13,9
01fc1290,135005,137905,0,1,2900,13,9
02ebc9a2,135005,138265,2,2,3260,13,9
0849b048,135005,138625,8,8,3620,13,9
087901c1,135005,138985,1,8,3980,13,9
05761375,135005,139345,5,5,4340,13,9
08d945c1,135005,139705,1,8,4700,13,9
04cdb127,135005,140065,7,4,5060,13,9
01f38868,135005,140425,8,1,5420,13,9
0491ae64,135005,140785,4,4,5780,13,9
07fcf0e6,135005,141145,6,7,6140,13,9
084bf943,135005,141505,3,8,6500,13,9
088e4fa6,337105,337485,6,8,380,13,9
04578a17,337235,337845,7,4,610,13,9
04791868,337335,338205,8,4,870,13,9
08175c10,337475,338565,0,8,1090,13,9
08c59f51,337385,338925,1,8,1540,13,9
04409175,337165,339675,5,4,2510,13,9
03396506,337365,340035,6,3,2670,13,9
00488358,337425,340405,8,0,2980,13,9
02574c55,337565,340855,5,2,3290,13,9
01efda97,438315,438705,7,1,390,13,9
078d14e8,438245,439065,8,7,820,13,9
07c42730,438165,439425,0,7,1260,13,9
020168a1,438215,439785,1,2,1570,13,9
04b80a83,438305,440155,3,4,1850,13,9
02bb90e4,438445,440515,4,2,2070,13,9
02a8ca13,438405,441005,3,2,2600,13,9
04fa8793,539305,539815,3,4,510,13,9
0b535248,1035,1555,8,11,520,8,13
0695e818,12015,12465,3,6,450,8,13
0c4d6098,23075,23565,8,12,490,8,13
0097b0d8,23195,24155,8,0,960,8,13
06f998d8,34085,34585,9,6,500,8,13
04752124,34245,34975,12,4,730,8,13
00dcd3d6,34445,35365,2,0,920,8,13
00724c6b,34585,35725,3,0,1140,8,13
06284651,34145,36085,4,6,1940,8,13
083f1763,34425,36445,5,8,2020,8,13
08457edc,34455,36805,6,8,2350,8,13
0c7cd0d6,34345,37165,7,12,2820,8,13
033e3018,34255,37525,8,3,3270,8,13
018495c0,35315,37885,9,1,2570,8,13
09ff7e52,34845,38255,11,9,3410,8,13
0a3d2aa4,34755,38615,12,10,3860,8,13
05a4ec5c,35245,38985,1,5,3740,8,13
00ccc9db,35835,39345,2,0,3510,8,13
02421201,35715,39715,4,2,4000,8,13
05696ce8,35155,40085,6,5,4930,8,13
09845aa9,35795,40445,7,9,4650,8,13
06c380d3,36015,40805,8,6,4790,8,13
077d6538,36115,41165,9,7,5050,8,13
06b582d8,35415,41535,11,6,6120,8,13
0003e965,35935,41925,1,0,5990,8,13
0afdd6b5,36185,42285,2,10,6100,8,13
07976675,135005,135385,5,7,380,8,13
0274a027,135005,135745,7,2,740,8,13
0c8bdf2a,135005,136105,10,12,1100,8,13
0bbf9c61,135005,136465,1,11,1460,8,13
011559fc,135005,137185,12,1,2180,8,13
06e32492,135005,137545,2,6,2540,8,13
0c25a776,135005,137905,6,12,2900,8,13
0892f855,135005,138265,5,8,3260,8,13
05a0c8ea,135005,138625,10,5,3620,8,13
008565f1,135005,138985,1,0,3980,8,13
0c36cda2,135005,139345,2,12,4340,8,13
0c6adab0,135005,139705,0,12,4700,8,13
0a4bf946,135005,140065,6,10,5060,8,13
0730acaa,135005,140425,10,7,5420,8,13
0350deb9,135005,140785,9,3,5780,8,13
0424185a,135005,141145,10,4,6140,8,13
09bc05b6,135005,141865,6,9,6860,8,13
08ccec2a,135005,142225,10,8,7220,8,13
0b28f1f2,135005,142585,2,11,7580,8,13
09563588,135005,142945,8,9,7940,8,13
0b9a82f6,135005,143305,6,11,8300,8,13
0cfc1294,135005,143665,4,12,8660,8,13
0b40cd0b,135005,144025,11,11,9020,8,13
08eed562,135005,144385,2,8,9380,8,13
070b7d99,337045,337535,9,7,490,8,13
08b49cac,337255,337925,12,8,670,8,13
074266d1,337115,338295,1,7,1180,8,13
075e2764,337155,338685,4,7,1530,8,13
0272db68,438065,438575,8,2,510,8,13
0a371954,438165,439085,4,10,920,8,13
0aebab43,539355,539765,3,10,410,8,13
0d535243,1095,1615,3,13,520,5,15
0e95e814,12095,12605,2,14,510,5,15
0b4d609c,23025,23505,12,11,480,5,15
0df998d0,34205,34585,1,13,380,5,15
04056632,34075,34945,2,4,870,5,15
0d784c52,34915,35315,4,13,400,5,15
04de9f9d,34825,36035,6,4,1210,5,15
0d3e301c,34355,36405,8,13,2050,5,15
0b7cd0db,34425,36765,9,11,2340,5,15
02845aa8,35975,37125,10,2,1150,5,15
08457ed3,34655,37485,11,8,2830,5,15
0497b0d9,34175,37845,12,4,3670,5,15
07069f20,35295,38205,13,7,2910,5,15
08752124,34335,38565,14,8,4230,5,15
0b724c67,34865,39285,1,11,4420,5,15
0edcd3d7,34595,39645,2,14,5050,5,15
0607ae83,35395,40005,3,6,4610,5,15
02b582dc,35645,40365,4,2,4720,5,15
03e28bdd,35635,40775,8,3,5140,5,15
048495c5,35535,41135,9,4,5600,5,15
03272779,35085,41505,11,3,6420,5,15
0b696ce9,35365,41865,12,11,6500,5,15
04421206,35955,42225,13,4,6270,5,15
0a3d2aa6,34985,42585,14,10,7600,5,15
0a726651,35695,42945,0,10,7250,5,15
00ccc9d8,36025,43305,1,0,7280,5,15
0530762e,135005,135745,14,5,740,5,15
09d60b70,135005,136105,0,9,1100,5,15
0ce3249d,135005,136465,13,12,1460,5,15
09d7f0c4,135005,136825,4,9,1820,5,15
09cdb12c,135005,137185,12,9,2180,5,15
052ae3f8,135005,137905,8,5,2900,5,15
04ff29c3,135005,138265,3,4,3260,5,15
013b8137,135005,138625,7,1,3620,5,15
0274a02a,135005,138985,10,2,3980,5,15
0d9650a3,135005,139345,3,13,4340,5,15
084b3418,135005,139705,8,8,4700,5,15
07265b6e,135005,140065,14,7,5060,5,15
0199bf15,135005,140785,5,1,5780,5,15
0b9a18f7,135005,141145,7,11,6140,5,15
0b7fc519,135005,141865,9,11,6860,5,15
0525a775,135005,142225,5,5,7220,5,15
06a595b7,135005,142945,7,6,7940,5,15
02f38861,135005,143305,1,2,8300,5,15
0d617739,135005,143665,9,13,8660,5,15
01fdd6b4,135005,144025,4,1,9020,5,15
0d572cfb,135005,144385,11,13,9380,5,15
0aa12890,135005,145105,0,10,10100,5,15
0d502bcd,135005,145465,13,13,10460,5,15
042554f4,135005,145825,4,4,10820,5,15
0a90d44b,337095,337575,11,10,480,5,15
0a8565f1,337035,338005,1,10,970,5,15
0cb36cb4,438145,438525,4,12,380,5,15
088fdf77,438085,438915,7,8,830,5,15
0291ae6d,539095,539705,13,2,610,5,15
00535244,1015,1475,4,0,460,9,13
024d6091,12085,12545,7,2,460,9,13
0295e818,12075,12955,11,2,880,9,13
0297b0d9,12185,13315,12,2,1130,9,13
02056637,12095,13675,0,2,1580,9,13
02f998d6,12195,14145,7,2,1950,9,13
0528465b,23075,23625,11,5,550,9,13
063e301b,23195,24215,11,6,1020,9,13
0291ae61,135005,135385,1,2,380,9,13
053f176a,135005,135745,10,5,740,9,13
09b582d4,135005,136465,4,9,1460,9,13
073b813b,135005,136825,11,7,1820,9,13
0a449238,135005,137185,8,10,2180,9,13
00a12891,135005,137545,1,0,2540,9,13
03241858,135005,137905,8,3,2900,9,13
035fb4c5,135005,138265,5,3,3260,9,13
09e32490,135005,138625,0,9,3620,9,13
022ed3d3,135005,138985,3,2,3980,9,13
02a595b9,135005,139345,9,2,4340,9,13
00dbc267,135005,139705,7,0,4700,9,13
05e94dfa,135005,140065,10,5,5060,9,13
043d2aa9,135005,140425,9,4,5420,9,13
078495c2,135005,140785,2,7,5780,9,13
08ccc9d8,135005,141145,8,8,6140,9,13
07fe91d7,135005,141505,7,7,6500,9,13
0cb34d8a,135005,141865,10,12,6860,9,13
0179a0bc,135005,142225,12,1,7220,9,13
09c4bd90,135005,142585,0,9,7580,9,13
0cbc05b8,135005,142945,8,12,7940,9,13
047edc83,135005,143305,3,4,8300,9,13
0892f85b,135005,143665,11,8,8660,9,13
0cff29cc,135005,144025,12,12,9020,9,13
0a8fdf7c,135005,144385,12,10,9380,9,13
0340cd09,337105,337535,9,3,430,9,13
001ff44a,337075,337895,10,0,820,9,13
0990b2a6,337135,338405,6,9,1270,9,13
066adab5,438045,438495,5,6,450,9,13
0bfcf0e6,438125,438855,6,11,730,9,13
08102c32,539305,539695,2,8,390,9,13
02535243,1065,1495,3,2,430,13,9
0495e814,12055,12585,7,4,530,13,9
04056630,12205,12945,8,4,740,13,9
043e3010,12415,13305,0,4,890,13,9
044d6095,12145,13665,1,4,1520,13,9
04752121,12395,14035,3,4,1640,13,9
047cd0d7,12475,14755,5,4,2280,13,9
04dcd3d7,12555,15115,6,4,2560,13,9
04284652,12335,15485,8,4,3150,13,9
04f998d2,12305,15855,1,4,3550,13,9
04457ed1,12605,16225,3,4,3620,13,9
04df78c7,12625,16595,5,4,3970,13,9
06de9f95,23065,23545,5,6,480,13,9
06069f25,23495,24055,5,6,560,13,9
0707ae85,23675,24565,5,7,890,13,9
043870a4,34475,34965,0,4,490,13,9
02f62631,34395,35325,1,2,930,13,9
06ccc9d6,34645,36045,3,6,1400,13,9
07572cf4,35075,36405,4,7,1330,13,9
03e28bd2,34235,36765,5,3,2530,13,9
0303e962,34705,37125,6,3,2420,13,9
05b22806,34525,37495,8,5,2970,13,9
08fdd6b2,34855,37855,0,8,3000,13,9
089650a2,35195,38215,1,8,3020,13,9
014b3417,35485,38575,2,1,3090,13,9
087d6533,34775,38935,3,8,4160,13,9
06e618a0,35425,39295,4,6,3870,13,9
028bdf20,35325,40015,6,2,4690,13,9
0562ad53,34905,40385,8,5,5480,13,9
0214c3c5,35255,40745,0,2,5490,13,9
05daddc6,135005,135385,6,5,380,13,9
0665d933,135005,135745,3,6,740,13,9
07261f78,135005,136105,8,7,1100,13,9
020f3785,135005,136465,5,2,1460,13,9
056333a7,135005,136825,7,5,1820,13,9
06bc05b5,135005,137185,5,6,2180,13,9
045007e4,135005,137545,4,4,2540,13,9
00a0c8e5,135005,137905,5,0,2900,13,9
068db5a8,135005,138265,8,6,3260,13,9
0171a462,135005,138985,2,1,3980,13,9
01e07290,135005,139345,0,1,4340,13,9
034569f8,135005,140065,8,3,5060,13,9
062ed3d3,135005,140425,3,6,5420,13,9
01563584,135005,140785,4,1,5780,13,9
046adab2,135005,141505,2,4,6500,13,9
05504738,438285,438715,8,5,430,13,9
055c4700,438265,439075,0,5,810,13,9
03ea7661,438205,439435,1,3,1230,13,9
01199ba6,539045,539565,6,1,520,13,9
0861ab67,539625,540115,7,8,490,13,9
02535241,1075,1575,1,2,500,12,12
0295e816,12105,12645,4,2,540,12,12
024d6097,12145,13005,5,2,860,12,12
0b05663a,23065,23525,10,11,460,12,12
093f176a,23485,24095,10,9,610,12,12
03457ed3,34095,34475,7,3,380,12,12
01784c52,34325,34835,8,1,510,12,12
01272770,34465,35195,9,1,730,12,12
02ff7e55,34405,35555,10,2,1150,12,12
0acdb8f9,34535,35915,11,10,1380,12,12
07dcd3d8,34085,36275,0,7,2190,12,12
03724c6a,34265,36635,1,3,2370,12,12
0bdf78ca,34185,36995,2,11,2810,12,12
063d2aa8,34375,37355,3,6,2980,12,12
00b22801,35085,37715,4,0,2630,12,12
04fdd6b9,35515,38075,5,4,2560,12,12
05f62638,35015,39165,9,5,4150,12,12
0b845aa6,35205,39525,10,11,4320,12,12
0162ad51,35605,39885,11,1,4280,12,12
0663eae2,35665,40245,0,6,4580,12,12
0030aca6,36025,40605,1,0,4580,12,12
07421203,35165,40965,2,7,5800,12,12
07fe91d4,35705,41335,4,7,5630,12,12
083870a5,35065,41725,7,8,6660,12,12
029650a8,35925,42085,8,2,6160,12,12
067d6536,35495,42445,9,6,6950,12,12
0b572cf6,35785,42805,10,11,7020,12,12
0b12f967,135005,135385,7,11,380,12,12
0b92f85b,135005,135745,11,11,740,12,12
0261773a,135005,136105,10,2,1100,12,12
0736cda8,135005,136465,8,7,1460,12,12
08f72fd9,135005,136825,9,8,1820,12,12
0bf2c041,135005,137185,1,11,2180,12,12
06261f7b,135005,137545,11,6,2540,12,12
057901c4,135005,137905,4,5,2900,12,12
01000b98,135005,138265,8,1,3260,12,12
0779a0bb,135005,138985,11,7,3980,12,12
061559f3,135005,139345,3,6,4340,12,12
0b28f1f2,135005,139705,2,11,4700,12,12
01599fa1,135005,140065,1,1,5060,12,12
09fc1291,135005,140425,1,9,5420,12,12
0bdaddc2,135005,140785,2,11,5780,12,12
067a6fd6,135005,141865,6,6,6860,12,12
09e05d52,135005,142225,2,9,7220,12,12
09a9b7e5,135005,142585,5,9,7580,12,12
0a502bc8,135005,142945,8,10,7940,12,12
00307623,135005,143305,3,0,8300,12,12
04ec0d70,135005,143665,0,4,8660,12,12
00578a1b,337015,337575,11,0,560,12,12
0bc59f51,337135,337945,1,11,810,12,12
0a574c53,337235,338315,3,10,1080,12,12
09791865,337095,338685,5,9,1590,12,12
091b4988,337285,339075,8,9,1790,12,12
07c4273a,337375,339445,10,7,2070,12,12
03a8a29b,337165,339805,11,3,2640,12,12
00175c15,337225,340585,5,0,3360,12,12
006c09f8,438465,438855,8,0,390,12,12
02a1d2a9,438525,439215,9,2,690,12,12
06a8ca10,438345,439605,0,6,1260,12,12
085f48d6,438585,440385,6,8,1800,12,12
0859dba6,539535,540005,6,8,470,12,12
00bddb68,539475,540375,8,0,900,12,12
09345ca0,539285,540785,0,9,1500,12,12
02535246,1095,1675,6,2,580,11,15
054d609c,12095,12485,11,5,390,11,15
05284659,12355,12845,12,5,490,11,15
05752129,12385,13205,13,5,820,11,15
05f998dc,12325,13595,1,5,1270,11,15
0595e81a,12015,13955,2,5,1940,11,15
053e3011,12475,14735,8,5,2260,11,15
0597b0d2,12245,15095,9,5,2850,11,15
053f1764,12595,16035,8,5,3440,11,15
05dcd3d6,12605,16395,9,5,3790,11,15
06457edb,23075,23485,11,6,410,11,15
0d27277b,23325,24115,11,13,790,11,15
093870ad,34555,34985,4,9,430,11,15
0dcdb8f8,34115,35345,5,13,1230,11,15
0c07ae86,34305,35705,6,12,1400,11,15
0a8495c2,34425,36435,9,10,2010,11,15
02696ce8,34225,36795,10,2,2570,11,15
03a4ec50,34375,37205,14,3,2830,11,15
05e28bd6,34445,37595,2,5,3150,11,15
0b726659,34535,38045,8,11,3510,11,15
0ab582d6,34525,38405,9,10,3880,11,15
05f62635,34545,38895,2,5,4350,11,15
0961773d,135005,135745,13,9,740,11,15
062e2eda,135005,136105,10,6,1100,11,15
0adaddcb,135005,136465,11,10,1460,11,15
04bc4b88,135005,136825,8,4,1820,11,15
0272db63,135005,137185,3,2,2180,11,15
07c9c2ee,135005,137545,14,7,2540,11,15
04504734,135005,137905,4,4,2900,11,15
0561ab6a,135005,138265,10,5,3260,11,15
06fe91d6,135005,138985,6,6,3980,11,15
01a1289e,135005,139345,14,1,4340,11,15
04c603b9,135005,139705,9,4,4700,11,15
02d60b75,135005,140065,5,2,5060,11,15
04ccec24,135005,140425,4,4,5420,11,15
08599fa1,135005,140785,1,8,5780,11,15
048db5a5,135005,141145,5,4,6140,11,15
0c6adabd,135005,141505,13,12,6500,11,15
07e8a38e,135005,141865,14,7,6860,11,15
035e2761,135005,142225,1,3,7220,11,15
070042db,135005,142585,11,7,7580,11,15
0bea7668,135005,142945,8,11,7940,11,15
04921c06,135005,143305,6,4,8300,11,15
0c8e4fa1,135005,143665,1,12,8660,11,15
0474a026,135005,144025,6,4,9020,11,15
00b34d85,135005,144385,5,0,9380,11,15
0d24185e,135005,144745,14,13,9740,11,15
009a18f5,135005,145105,5,0,10100,11,15
0112f96a,135005,145465,10,1,10460,11,15
03bf6d3b,135005,145825,11,3,10820,11,15
0148835b,337195,337575,11,1,380,11,15
0879186c,337065,337935,12,8,870,11,15
04574c5d,337455,338295,13,4,840,11,15
09175c10,337375,338665,0,9,1290,11,15
0cc59f52,337175,339385,2,12,2210,11,15
00a8a295,337285,339775,5,0,2490,11,15
0b1b4986,337505,340135,6,11,2630,11,15
04396508,337165,340505,8,4,3340,11,15
0427b4bb,337545,340895,11,4,3350,11,15
0bb80a84,438185,438615,4,11,430,11,15
0bbb90e5,438395,438975,5,11,580,11,15
04a8ca18,438315,439365,8,4,1050,11,15
0eefda94,438255,439915,4,14,1660,11,15
065f48d1,539275,539945,1,6,670,11,15
00535243,1045,1615,3,0,570,10,12
0095e81b,12065,12465,7,0,400,10,12
004d6092,12095,12855,10,0,760,10,12
00f998da,12235,13215,11,0,980,10,12
00056630,12125,13685,6,0,1560,10,12
00284656,12305,14045,7,0,1740,10,12
0097b0d8,12225,14595,6,0,2370,10,12
0075212a,23075,23525,10,0,450,10,12
02de9f9a,23505,24095,10,2,590,10,12
0b784c5a,23585,24665,10,11,1080,10,12
033d2aa4,34015,34465,7,3,450,10,12
04e28bd1,34425,34835,9,4,410,10,12
01ff7e58,34045,35205,11,1,1160,10,12
07069f28,34185,35925,1,7,1740,10,12
052d6123,34105,36285,2,5,2180,10,12
02c380d5,34865,36645,3,2,1780,10,12
0b272777,34075,37005,4,11,2930,10,12
09b582d7,34525,37365,5,9,2840,10,12
01a4ec58,34365,37725,6,1,3360,10,12
06cdb8f6,34115,38085,7,6,3970,10,12
0574a027,35115,38805,9,5,3690,10,12
077d6538,34965,39165,10,7,4200,10,12
09fdd6b0,34975,39525,11,9,4550,10,12
08ccc9d1,34755,39885,0,8,5130,10,12
06e618a1,35645,40245,1,6,4600,10,12
01fdd2ab,36195,40605,2,1,4410,10,12
0699bf1a,36775,40965,3,6,4190,10,12
0a8bdf2a,35605,41325,4,10,5720,10,12
0614c3c7,35545,41685,5,6,6140,10,12
016333aa,36565,42045,6,1,5480,10,12
05c4bd92,36845,42405,7,5,5560,10,12
02a4b155,36715,43125,9,2,6410,10,12
005fb4c2,36935,43485,10,0,6550,10,12
0a241857,36365,43845,11,10,7480,10,12
0479a0bb,36265,44205,0,4,7940,10,12
05307625,36905,44565,1,5,7660,10,12
047be71a,36335,44925,2,4,8590,10,12
08f38864,135005,135385,4,8,380,10,12
0690d443,135005,135745,3,6,740,10,12
07e94df6,135005,136105,6,7,1100,10,12
07102c38,135005,136465,8,7,1460,10,12
0165d933,135005,136825,3,1,1820,10,12
06371950,135005,137185,0,6,2180,10,12
025c470a,135005,137905,10,2,2900,10,12
01921c01,135005,138265,1,1,3260,10,12
039a18f5,135005,138625,5,3,3620,10,12
057fc51a,135005,138985,10,5,3980,10,12
069e7399,135005,139345,9,6,4340,10,12
08292b31,135005,139705,1,8,4700,10,12
07fb6658,135005,140065,8,7,5060,10,12
07ebc9a5,135005,140425,5,7,5420,10,12
01bc4b81,135005,140785,1,1,5780,10,12
0ab49ca7,135005,141145,7,10,6140,10,12
020042d5,135005,141505,5,2,6500,10,12
017c63db,135005,141865,11,1,6860,10,12
07761375,135005,142225,5,7,7220,10,12
05d80db4,135005,142585,4,5,7580,10,12
0533ed0b,135005,142945,11,5,7940,10,12
045007e8,135005,143305,8,4,8300,10,12
0bcaf2a5,135005,143665,5,11,8660,10,12
058e4fa8,337055,337515,8,5,460,10,12
0740917b,337135,337905,11,7,770,10,12
08791864,337225,338665,4,8,1440,10,12
0b488355,438205,438655,5,11,450,10,12
06175c18,438295,439045,8,6,750,10,12
06a8a290,438225,439455,0,6,1230,10,12
0a574c51,438355,439815,1,10,1460,10,12
081b4984,539065,539505,4,8,440,10,12
0427b4b9,539075,539935,9,4,860,10,12
07535248,1005,1555,8,7,550,5,13
00056638,23075,23565,8,0,490,5,13
01752122,34115,34545,7,1,430,5,13
093e3015,34205,34935,10,9,730,5,13
05de9f96,34485,35295,11,5,810,5,13
08284652,34095,35655,12,8,1560,5,13
03dcd3d3,34345,36015,0,3,1670,5,13
05724c61,34565,36375,1,5,1810,5,13
00457ed9,34405,36785,5,0,2380,5,13
0a7cd0d6,34285,37145,6,10,2860,5,13
09ff7e52,34695,37895,10,9,3200,5,13
07784c56,34615,38265,12,7,3650,5,13
03272773,34745,38625,0,3,3880,5,13
00df78c9,34475,39055,5,0,4580,5,13
07e32493,135005,135385,3,7,380,5,13
02e28bd4,135005,136105,4,2,1100,5,13
0b3b8133,135005,136825,3,11,1820,5,13
0b74a020,135005,137185,0,11,2180,5,13
044b341b,135005,137905,11,4,2900,5,13
09265b63,135005,138265,3,9,3260,5,13
0079a0b0,135005,138625,0,0,3620,5,13
066333ac,135005,138985,12,6,3980,5,13
03307623,135005,139345,3,3,4340,5,13
0cd60b79,135005,139705,9,12,4700,5,13
027fc512,135005,140065,2,2,5060,5,13
0aa4ec58,135005,140425,8,10,5420,5,13
06f62632,135005,140785,2,6,5780,5,13
07ccc9d5,135005,141145,5,7,6140,5,13
01fdd6b3,135005,141505,3,1,6500,5,13
07572cf6,135005,141865,6,7,6860,5,13
078bdf25,135005,142225,5,7,7220,5,13
0ba12891,135005,142585,1,11,7580,5,13
0b502bc3,135005,142945,3,11,7940,5,13
012554fa,135005,143305,10,1,8300,5,13
0799bf16,135005,143665,6,7,8660,5,13
039a18fc,135005,144025,12,3,9020,5,13
0cbc05bc,135005,144385,12,12,9380,5,13
0c25a77a,337105,337555,10,12,450,5,13
012ed3d7,337205,338085,7,1,880,5,13
01cdb123,438015,438435,3,1,420,5,13
0c5007e3,438085,439025,3,12,940,5,13
099e7393,539135,539545,3,9,410,5,13
0095e812,12025,12425,2,0,400,9,3
00752121,12435,13155,2,0,720,9,3
003e3010,12475,13545,2,0,1070,9,3
02724c60,23365,23835,0,2,470,9,3
00784c50,34095,34475,1,0,380,9,3
00ff7e52,34195,34835,2,0,640,9,3
013d2aa1,34155,35195,0,1,1040,9,3
02a4ec52,34575,35555,1,2,980,9,3
0262ad52,35365,36635,1,2,1270,9,3
00572cf2,35695,36995,2,0,1300,9,3
024b3410,35985,37715,1,2,1730,9,3
00572cf2,35695,38075,2,0,2380,9,3
024b3410,35985,38795,1,2,2810,9,3
02a4b150,135005,135385,0,2,380,9,3
024569f1,135005,135745,1,2,740,9,3
02f38861,337395,338855,1,2,1460,9,3
01a0c8e2,337405,339215,2,1,1810,9,3
019a82f2,438415,439745,2,1,1330,9,3
002e2ed2,539435,539875,2,0,440,9,3
02fc1290,539345,540235,0,2,890,9,3
0236cda1,539485,540595,1,2,1110,9,3
0753524b,1005,1615,11,7,610,1,13
0995e814,12085,12625,11,9,540,1,13
0a4d6090,23055,23665,0,10,610,1,13
0197b0d3,34075,34465,3,1,390,1,13
02056632,34035,34835,5,2,800,1,13
0b3f1765,34385,35205,7,11,820,1,13
0b284657,34135,35565,8,11,1430,1,13
06457ed5,34465,35925,9,6,1460,1,13
05069f26,35205,36285,10,5,1080,1,13
037cd0d2,34325,36645,11,3,2320,1,13
07726657,35555,37365,0,7,1810,1,13
0cf998d2,34115,37725,1,12,3610,1,13
05df78c0,34535,38085,2,5,3550,1,13
0197b0d3,34075,38445,3,1,4370,1,13
0030acab,36495,38805,4,0,2310,1,13
02056632,34035,39165,5,2,5130,1,13
04b582db,35455,39525,6,4,4070,1,13
0b3f1765,34385,39885,7,11,5500,1,13
0b284657,34135,40245,8,11,6110,1,13
06457ed5,34465,40605,9,6,6140,1,13
05069f26,35205,40965,10,5,5760,1,13
037cd0d2,34325,41325,11,3,7000,1,13
07726657,35555,42045,0,7,6490,1,13
0cf998d2,34115,42405,1,12,8290,1,13
05df78c0,34535,42765,2,5,8230,1,13
0197b0d3,34075,43125,3,1,9050,1,13
0030acab,36495,43485,4,0,6990,1,13
02056632,34035,43845,5,2,9810,1,13
04b582db,35455,44205,6,4,8750,1,13
0b3f1765,34385,44565,7,11,10180,1,13
0b284657,34135,44925,8,11,10790,1,13
06457ed5,34465,45285,9,6,10820,1,13
05069f26,35205,45645,10,5,10440,1,13
0b4569f3,135005,135385,3,11,380,1,13
08c603b1,135005,135745,1,8,740,1,13
0a3327e6,135005,136465,6,10,1460,1,13
01a4b158,135005,136825,8,1,1820,1,13
0699bf17,135005,137185,7,6,2180,1,13
0ac4bd96,135005,137545,6,10,2540,1,13
02307624,135005,137905,4,2,2900,1,13
065fb4c7,135005,138265,7,6,3260,1,13
091559fb,135005,138625,11,9,3620,1,13
029a18fc,135005,138985,12,2,3980,1,13
05da9f8c,135005,139345,12,5,4340,1,13
00d60b74,135005,139705,4,0,4700,1,13
03e37890,539085,539695,0,3,610,1,13
01535246,1095,1595,6,1,500,11,7
0195e815,12045,12445,5,1,400,11,7
01056630,12185,12815,0,1,630,11,7
01f998d5,12325,13185,2,1,860,11,7
0197b0d4,12265,13575,5,1,1310,11,7
06284654,23065,23565,4,6,500,11,7
027cd0d4,23195,24035,4,2,840,11,7
023f1763,34055,34465,6,2,410,11,7
06df78c2,34215,34835,1,6,620,11,7
04dcd3d5,34105,35555,3,4,1450,11,7
05272772,34405,35915,4,5,1510,11,7
06784c56,34315,36275,5,6,1960,11,7
013d2aa6,34355,36635,6,1,2280,11,7
04cdb8f2,34495,36995,0,4,2500,11,7
032d6122,34465,37355,1,3,2890,11,7
063870a6,35025,37715,2,6,2690,11,7
0503e963,35335,38075,3,5,2740,11,7
03fe91d6,35865,38435,4,3,2570,11,7
04572cf1,35935,39155,6,4,3220,11,7
0430aca3,36145,39515,0,4,3370,11,7
047d6533,35585,39875,1,4,4290,11,7
03ccc9d4,35265,40235,2,3,4970,11,7
0214c3c6,36235,40595,3,2,4360,11,7
029650a0,36065,40955,4,2,4890,11,7
01ec0d75,135005,135745,5,1,740,11,7
059e7390,135005,136105,0,5,1100,11,7
01a0c8e0,135005,136465,0,1,1460,11,7
05b36cb5,135005,136825,5,5,1820,11,7
03e618a0,135005,137185,0,3,2180,11,7
0379a0b4,135005,137545,4,3,2540,11,7
06e32490,135005,137905,0,6,2900,11,7
005007e6,135005,138265,6,0,3260,11,7
00563585,135005,138625,5,0,3620,11,7
0290d442,135005,138985,2,2,3980,11,7
01119792,135005,139345,2,1,4340,11,7
05502bc1,135005,139705,1,5,4700,11,7
00c4bd93,135005,140065,3,0,5060,11,7
03ebc9a0,337065,337495,0,3,430,11,7
061340a3,438305,438695,3,6,390,11,7
00976675,438285,439415,5,0,1130,11,7
05e8a386,438355,439775,6,5,1420,11,7
04187791,438455,440145,1,4,1690,11,7
064266d3,539495,539905,3,6,410,11,7
02cde4d0,539415,540315,0,2,900,11,7
060b7d91,539485,540675,1,6,1190,11,7
07056634,12205,12825,0,7,620,7,8
074d6096,12135,13255,5,7,1120,7,8
07f998d1,12315,13745,5,7,1430,7,8
01752126,34035,34425,5,1,390,7,8
01457ed3,34265,35145,7,1,880,7,8
05069f21,34825,35505,0,5,680,7,8
05dcd3d7,34215,36225,2,5,2010,7,8
07272775,34695,36585,3,7,1890,7,8
053f1761,34135,36945,4,5,2810,7,8
03df78c4,34335,37305,5,3,2970,7,8
0707ae84,34965,37665,6,7,2700,7,8
05de9f91,34385,38025,7,5,3640,7,8
05b582d5,35195,38385,0,5,3190,7,8
06fdd6b3,35805,38745,1,6,2940,7,8
04572cf4,36015,39105,2,4,3090,7,8
0030aca0,36185,39465,3,0,3280,7,8
0214c3c6,36265,39825,4,2,3560,7,8
02c380d7,35725,40185,5,2,4460,7,8
0403e963,35625,40905,7,4,5280,7,8
030f3787,36515,41265,0,3,4750,7,8
05b34d82,36495,41625,1,5,5130,7,8
02bc05b4,135005,135385,4,2,380,7,8
02d7f0c2,135005,135745,2,2,740,7,8
015816d6,135005,136105,6,1,1100,7,8
02b4b492,135005,136465,2,2,1460,7,8
05599fa2,135005,136825,2,5,1820,7,8
05c603b4,135005,137545,4,5,2540,7,8
055fb4c7,135005,137905,7,5,2900,7,8
007fc515,135005,138265,5,0,3260,7,8
00cdb125,135005,138625,5,0,3620,7,8
03488780,135005,138985,0,3,3980,7,8
03a0c8e5,135005,139345,5,3,4340,7,8
06292b30,135005,139705,0,6,4700,7,8
03241857,135005,140065,7,3,5060,7,8
074569f5,135005,140785,5,7,5780,7,8
04fc1291,337015,337535,1,4,520,7,8
072e2ed3,337105,337905,3,7,800,7,8
04119796,337455,338635,6,4,1180,7,8
05ae2b57,337325,338995,7,5,1670,7,8
07fb6650,337265,339355,0,7,2090,7,8
0336cda1,337205,339715,1,3,2510,7,8
0340cd07,438085,438905,7,3,820,7,8
016adab3,438175,439315,3,1,1140,7,8
04f72fd7,539115,539615,7,4,500,7,8
06ebc9a0,539105,539975,0,6,870,7,8
0c535244,1015,1555,4,12,540,6,14
0b95e818,12095,12665,9,11,570,6,14
0197b0d4,23035,23565,4,1,530,6,14
08f998d4,23095,24175,4,8,1080,6,14
05752121,34095,34955,7,5,860,6,14
0d28465a,34055,35685,10,13,1630,6,14
07069f28,34935,36045,11,7,1110,6,14
02457edb,34315,36405,12,2,2090,6,14
09ff7e58,34645,36775,0,9,2130,6,14
00df78cc,34385,37135,1,0,2750,6,14
0a449234,36085,37495,2,10,1410,6,14
0c72665d,35225,37855,3,12,2630,6,14
07a4ec51,35075,38575,5,7,3500,6,14
0a272772,34685,38935,6,10,4250,6,14
04dcd3d0,34285,39295,7,4,5010,6,14
02cdb8f6,34865,39655,8,2,4790,6,14
06572cf4,36025,40015,9,6,3990,6,14
0ce28bd0,35125,40375,10,12,5250,6,14
0263eaea,35845,40735,11,2,4890,6,14
0accc9d2,35455,41095,12,10,5640,6,14
0a7d6536,35615,41465,0,10,5850,6,14
0562ad5b,35765,41825,1,5,6060,6,14
0074a027,35805,42195,3,0,6390,6,14
07fe91dc,35945,42565,5,7,6620,6,14
053870a5,35285,42925,6,5,7640,6,14
023b813d,35555,43285,7,2,7730,6,14
04fdd6b3,35665,43645,8,4,7980,6,14
062ae3f8,135005,135385,8,6,380,6,14
0b599fa3,135005,135745,3,11,740,6,14
098565f0,135005,136105,0,9,1100,6,14
06fc129d,135005,136465,13,6,1460,6,14
07119795,135005,136825,5,7,1820,6,14
0a30aca2,135005,137185,2,10,2180,6,14
0b0f3786,135005,137545,6,11,2540,6,14
05502bca,135005,137905,10,5,2900,6,14
07c603b3,135005,138265,3,7,3260,6,14
0030762d,135005,138625,13,0,3620,6,14
064569fb,135005,138985,11,6,3980,6,14
05ec0d72,135005,139345,2,5,4340,6,14
0925a77a,135005,139705,10,9,4700,6,14
0728f1f5,135005,140065,5,7,5060,6,14
04a0c8eb,135005,140425,11,4,5420,6,14
009a82f0,135005,140785,0,0,5780,6,14
0d91ae6c,135005,141145,12,13,6140,6,14
03ae2b58,135005,141505,8,3,6500,6,14
056adab4,135005,141865,4,5,6860,6,14
0a99bf15,135005,143305,5,10,8300,6,14
01da9f86,135005,143665,6,1,8660,6,14
04e32494,135005,144025,4,4,9020,6,14
05ccec2b,135005,144385,11,5,9380,6,14
0d5816dd,135005,144745,13,13,9740,6,14
06102c34,337095,337715,4,6,620,6,14
0beed568,337195,338125,8,11,930,6,14
029e94ed,337255,338555,13,2,1300,6,14
0697667a,438065,438615,10,6,550,6,14
031340ac,438135,438985,12,3,850,6,14
09bc4b8b,539205,539805,11,9,600,6,14
074bf94d,539235,540175,13,7,940,6,14
0553524b,1025,1535,11,5,510,2,12
0095e81a,12105,12525,10,0,420,2,12
004d6091,12165,13015,6,0,850,2,12
04056636,23045,23445,6,4,400,2,12
0997b0d9,34105,34565,0,9,460,2,12
08df78c1,34605,35655,4,8,1050,2,12
0b7cd0d3,34405,36025,6,11,1620,2,12
0a3e3017,34345,36385,7,10,2040,2,12
07284653,34205,36745,8,7,2540,2,12
00f998d1,34145,37105,9,0,2960,2,12
03784c54,34795,37465,10,3,2670,2,12
07752124,34245,38185,0,7,3940,2,12
08726658,35515,38545,1,8,3030,2,12
08a4ec59,35345,38905,2,8,3560,2,12
0074a022,36395,39275,4,0,2880,2,12
08845aa5,35835,39635,5,8,3800,2,12
0bb582d6,35445,39995,6,11,4550,2,12
048495c8,35375,40355,7,4,4980,2,12
05ff7e56,34905,40715,8,5,5810,2,12
06de9f99,34685,41075,9,6,6390,2,12
00e28bd2,35415,41435,10,0,6020,2,12
06457ed1,34555,41795,11,6,7240,2,12
07752124,34245,42155,0,7,7910,2,12
08726658,35515,42515,1,8,7000,2,12
073b8137,36085,42875,2,7,6790,2,12
0074a022,36395,43245,4,0,6850,2,12
037d6535,36225,43605,5,3,7380,2,12
0bb582d6,35445,43965,6,11,8520,2,12
048495c8,35375,44325,7,4,8950,2,12
05ff7e56,34905,44685,8,5,9780,2,12
06de9f99,34685,45045,9,6,10360,2,12
00e28bd2,35415,45405,10,0,9990,2,12
01da9f8b,135005,135385,11,1,380,2,12
034569f9,135005,135745,9,3,740,2,12
02bc05b1,135005,136105,1,2,1100,2,12
03e32492,135005,136465,2,3,1460,2,12
00ec0d77,135005,136825,7,0,1820,2,12
0512f96a,135005,137185,10,5,2180,2,12
00ccec24,135005,137545,4,0,2540,2,12
0225a772,135005,137905,2,2,2900,2,12
05cdb121,135005,138265,1,5,3260,2,12
0199bf1a,135005,138625,10,1,3620,2,12
0a30762b,135005,138985,11,10,3980,2,12
059e739b,337045,337905,11,5,860,2,12
0bbf6d36,539095,539585,6,11,490,2,12
0353524a,1085,1515,10,3,430,4,16
014d6096,12145,12545,11,1,400,4,16
0195e81d,12085,12915,13,1,830,4,16
0105663d,12155,13305,0,1,1150,4,16
0197b0dc,12175,13815,9,1,1640,4,16
00f998d4,23075,23725,4,0,650,4,16
08752124,23135,24375,4,8,1240,4,16
003e301f,34015,34605,14,0,590,4,16
0cdf78cc,34385,34975,0,12,590,4,16
0cdcd3d3,34245,35335,1,12,1090,4,16
01784c5c,34535,35695,2,1,1160,4,16
02272776,34715,36055,3,2,1340,4,16
03457ed6,34305,36415,4,3,2110,4,16
037cd0d3,34105,36775,5,3,2670,4,16
07ff7e53,34665,37135,6,7,2470,4,16
003f1768,34205,37495,7,0,3290,4,16
0dde9f96,34475,37865,9,13,3390,4,16
08069f26,34885,38225,10,8,3340,4,16
03b2280c,35525,38585,11,3,3060,4,16
012d612c,34775,38945,12,1,4170,4,16
043d2aa2,34625,39305,13,4,4680,4,16
0bb582d6,35285,39675,15,11,4390,4,16
06696ced,34985,40395,1,6,5410,4,16
0107ae81,35045,40755,2,1,5710,4,16
0d74a02f,35935,41475,4,13,5540,4,16
0703e96b,35725,41835,5,7,6110,4,16
0863eae8,35965,42195,6,8,6230,4,16
02c380d2,35795,42945,10,2,7150,4,16
0f421208,35565,43665,12,15,8100,4,16
0b7d6538,35835,44025,13,11,8190,4,16
0ff62634,35365,44415,0,15,9050,4,16
04572cf1,36095,44775,1,4,8680,4,16
0ffe91dc,35995,45135,2,15,9140,4,16
02502bc3,135005,135385,3,2,380,4,16
08241851,135005,135745,1,8,740,4,16
0c3327e0,135005,136105,0,12,1100,4,16
0530762c,135005,136465,12,5,1460,4,16
0fda9f80,135005,136825,0,15,1820,4,16
04bc05b4,135005,137185,4,4,2180,4,16
03ccec25,135005,137905,5,3,2900,4,16
05cdb123,135005,138265,3,5,3260,4,16
0228f1f6,135005,138625,6,2,3620,4,16
0ca595b5,135005,138985,5,12,3980,4,16
0c56358c,135005,139345,12,12,4340,4,16
03599fab,135005,139705,11,3,4700,4,16
004b3411,135005,140425,1,0,5420,4,16
0150deb8,135005,140785,8,1,5780,4,16
0d9a82f6,337075,337475,6,13,400,4,16
008565f3,438165,438575,3,0,410,4,16
088fdf74,438295,438935,4,8,640,4,16
0890d441,438265,439525,1,8,1260,4,16
01b36cb6,539025,539495,6,1,470,4,16
0a535242,1035,1595,2,10,560,2,12
0b95e814,12105,12665,5,11,560,2,12
0b4d6099,23035,23505,9,11,470,2,12
0297b0db,34085,34465,7,2,380,2,12
00284655,34245,35265,2,0,1020,2,12
05056635,34025,35625,3,5,1600,2,12
01f998d8,34155,35985,4,1,1830,2,12
0375212a,34305,36345,5,3,2040,2,12
083f1769,34475,36855,2,8,2380,2,12
007cd0d5,34425,37215,3,0,2790,2,12
05ff7e58,135005,135385,8,5,380,2,12
052d612a,135005,135745,10,5,740,2,12
07069f20,135005,136105,0,7,1100,2,12
0207ae87,135005,136465,7,2,1460,2,12
088495cb,135005,136825,11,8,1820,2,12
05f62630,135005,137545,0,5,2540,2,12
05845aa3,135005,138265,3,5,3260,2,12
0b457ed9,135005,138625,9,11,3620,2,12
02de9f92,135005,138985,2,2,3980,2,12
01784c56,135005,139345,6,1,4340,2,12
093b813b,337165,337575,11,9,410,2,12
0603e961,337085,337945,1,6,860,2,12
04c380d5,438075,438525,5,4,450,2,12
07535240,1065,1455,0,7,390,10,11
0095e818,12055,12545,4,0,490,10,11
00284650,12445,12905,5,0,460,10,11
00056632,12215,13265,6,0,1050,10,11
004d6094,12135,13625,7,0,1490,10,11
0097b0d7,12305,13985,8,0,1680,10,11
007cd0da,12645,14765,3,0,2120,10,11
003e3014,12605,15125,4,0,2520,10,11
00752128,12535,15485,5,0,2950,10,11
0a3f1769,23035,23425,9,10,390,10,11
02724c68,34105,34605,7,2,500,10,11
043d2aa6,34235,34965,8,4,730,10,11
05ff7e50,34315,35775,4,5,1460,10,11
0a272770,34365,36165,7,10,1800,10,11
012ed3d6,135005,135385,6,1,380,10,11
06b4b49a,135005,135745,10,6,740,10,11
06bb4a38,135005,136105,8,6,1100,10,11
062e2ed3,135005,136465,3,6,1460,10,11
05cdb8f4,135005,136825,4,5,1820,10,11
073870a8,135005,137185,8,7,2180,10,11
0562ad56,135005,137545,6,5,2540,10,11
05e618a1,135005,137905,1,5,2900,10,11
0afdd2a0,135005,138265,0,10,3260,10,11
0ae37890,135005,138985,0,10,3980,10,11
03488789,135005,139345,9,3,4340,10,11
00dbc266,135005,139705,6,0,4700,10,11
028db5aa,135005,140065,10,2,5060,10,11
0290b2a7,135005,140425,7,2,5420,10,11
03726656,135005,140785,6,3,5780,10,11
027d6536,135005,141145,6,2,6140,10,11
0614c3c2,135005,141505,2,6,6500,10,11
01513ae8,135005,141865,8,1,6860,10,11
05a4b153,135005,142225,3,5,7220,10,11
09d945c4,135005,142585,4,9,7580,10,11
007edc80,135005,142945,0,0,7940,10,11
06bc4b85,438185,438565,5,6,380,10,11
02e8a388,438115,438955,8,2,840,10,11
00187791,438125,439365,1,0,1240,10,11
01f2c048,539155,539865,8,1,710,10,11
030b7d90,539355,540255,0,3,900,10,11
09535247,1075,1465,7,9,390,13,12
0095e810,12065,12585,1,0,520,13,12
004d6096,12135,12975,4,0,840,13,12
00f998d3,12335,13365,7,0,1030,13,12
00056635,12225,13755,10,0,1530,13,12
0097b0d3,12265,14145,1,0,1880,13,12
00284650,12425,14595,7,0,2170,13,12
0b3e3015,23095,23665,5,11,570,13,12
083d2aa5,23595,24235,5,8,640,13,12
07272772,34075,34525,10,7,450,13,12
052d612a,34095,34915,1,5,820,13,12
05069f23,34205,35405,9,5,1200,13,12
08cdb8f2,34195,35815,1,8,1620,13,12
0a7be712,135005,135385,2,10,380,13,12
01da9f83,135005,135745,3,1,740,13,12
087edc87,135005,136105,7,8,1100,13,12
082ae3f7,135005,136465,7,8,1460,13,12
0390d448,135005,136825,8,3,1820,13,12
0940cd09,135005,137185,9,9,2180,13,12
00e8a381,135005,137545,1,0,2540,13,12
0172db65,135005,137905,5,1,2900,13,12
0a1451c2,135005,138265,2,10,3260,13,12
0607ae8b,135005,138625,11,6,3620,13,12
033b8139,135005,138985,9,3,3980,13,12
078bdf22,135005,139345,2,7,4340,13,12
071559f9,135005,139705,9,7,4700,13,12
01d7f0c5,135005,140065,5,1,5060,13,12
04a595b7,135005,140425,7,4,5420,13,12
01292b38,135005,140785,8,1,5780,13,12
0b119791,135005,141145,1,11,6140,13,12
051340a1,135005,141505,1,5,6500,13,12
055e2769,135005,141865,9,5,6860,13,12
01c9c2e0,135005,142225,0,1,7220,13,12
01ab35e5,135005,142585,5,1,7580,13,12
08ccc9d7,135005,142945,7,8,7940,13,12
0630aca7,135005,143305,7,6,8300,13,12
04921c07,337095,337495,7,4,400,13,12
0959f26b,337135,337905,11,9,770,13,12
039837d1,337325,338275,1,3,950,13,12
0461ab65,337225,338685,5,4,1460,13,12
08157867,337435,339055,7,8,1620,13,12
02f0fdc5,337335,339585,5,2,2250,13,12
033b6cf6,438225,438665,6,3,440,13,12
06d2b798,438235,439035,8,6,800,13,12
07d80db0,438185,439445,0,7,1260,13,12
028e4fa6,438315,439895,6,2,1580,13,12
01396507,539335,539825,7,1,490,13,12
0d535248,1035,1425,8,13,390,13,15
0d95e817,12085,12465,10,13,380,13,15
0d4d6096,12095,12825,11,13,730,13,15
0d3e301a,12425,13275,2,13,850,13,15
0d7cd0d8,12495,13645,4,13,1150,13,15
0d284653,12325,14005,5,13,1680,13,15
0d97b0d8,12285,14365,6,13,2080,13,15
0d05663a,12185,14735,8,13,2550,13,15
0df998dd,12295,15105,10,13,2810,13,15
0d3f1760,12545,15695,8,13,3150,13,15
03dcd3db,23085,23485,11,3,400,13,15
083d2aab,23555,24745,11,8,1190,13,15
03272775,34025,34565,0,3,540,13,15
0c2d6129,34045,34935,2,12,890,13,15
08ff7e57,34015,35305,4,8,1290,13,15
09726650,34735,35665,5,9,930,13,15
09cdb8f5,34105,36035,7,9,1930,13,15
01f62635,34785,36395,8,1,1610,13,15
087d6534,35345,36755,9,8,1410,13,15
04c380d5,35255,37115,10,4,1860,13,15
04696ce4,34295,37475,11,4,3180,13,15
04b22801,34885,37835,12,4,2950,13,15
01fe91d7,35605,38195,13,1,2590,13,15
053b8131,35215,38555,14,5,3340,13,15
0707ae8d,34325,38915,0,7,4590,13,15
06e618ae,35935,39275,1,6,3340,13,15
04a4ec50,34405,39635,2,4,5230,13,15
064b341b,35985,39995,3,6,4010,13,15
0074a02b,35505,40355,4,0,4850,13,15
0a572cfb,35635,40715,5,10,5080,13,15
038bdf20,35895,41075,6,3,5180,13,15
0b069f23,34195,41435,7,11,7240,13,15
063870ab,34835,41795,8,6,6960,13,15
06449237,35695,42185,11,6,6490,13,15
0a14c3c7,35885,42545,12,10,6660,13,15
09b34d8e,36065,42905,13,9,6840,13,15
0362ad55,35455,43275,0,3,7820,13,15
049650a2,35755,43645,2,4,7890,13,15
0830acad,35825,44035,5,8,8210,13,15
01ebc9ad,135005,135385,13,1,380,13,15
06f2c049,135005,135745,9,6,740,13,15
01408daa,135005,136465,10,1,1460,13,15
04921c0a,135005,136825,10,4,1820,13,15
09409179,135005,137185,9,9,2180,13,15
070168a7,135005,137545,7,7,2540,13,15
0cfa8790,135005,137905,0,12,2900,13,15
06390864,135005,138265,4,6,3260,13,15
05a1289c,135005,138625,12,5,3620,13,15
073327e3,135005,138985,3,7,3980,13,15
03e3789c,135005,139345,12,3,4340,13,15
065816d2,135005,139705,2,6,4700,13,15
08ff29c8,135005,140065,8,8,5060,13,15
00fc1292,135005,140425,2,0,5420,13,15
0d4bf947,135005,140785,7,13,5780,13,15
0549b044,135005,141145,4,5,6140,13,15
0e7901ca,135005,141505,10,14,6500,13,15
0a761376,135005,141865,6,10,6860,13,15
0e8e4fa3,135005,142225,3,14,7220,13,15
00c42734,135005,142585,4,0,7580,13,15
015ff9ed,135005,142945,13,1,7940,13,15
0969ab45,135005,143305,5,9,8300,13,15
04b6afb5,135005,143665,5,4,8660,13,15
01c603b1,135005,144025,1,1,9020,13,15
07d945c0,135005,144385,0,7,9380,13,15
01cdb126,135005,144745,6,1,9740,13,15
0791ae6a,135005,145465,10,7,10460,13,15
00fcf0e7,135005,145825,7,0,10820,13,15
008568f8,337105,337515,8,0,410,13,15
045e788d,337295,337945,13,4,650,13,15
0d3819b0,337455,338315,0,13,860,13,15
01e45922,337515,338685,2,1,1170,13,15
03dbf6b5,337195,339075,5,3,1880,13,15
0a4df28b,337595,339525,11,10,1930,13,15
0afb4aed,337375,339895,13,10,2520,13,15
014e02d0,337695,340265,0,1,2570,13,15
003050d5,438255,438675,5,0,420,13,15
03cf61e8,438225,439065,8,3,840,13,15
049fdecc,438335,439475,12,4,1140,13,15
0e39d180,438385,439865,0,14,1480,13,15
02535243,1015,1515,3,2,500,13,11
014d6096,23015,23585,6,1,570,13,11
05dcd3d7,34095,34475,0,5,380,13,11
09784c53,34335,34835,1,9,500,13,11
03de9f98,34195,35195,2,3,1000,13,11
05696ce3,34755,35555,3,5,800,13,11
00457ed0,34155,35925,5,0,1770,13,11
05df78c3,34165,36285,6,5,2120,13,11
09069f28,34675,36645,7,9,1970,13,11
06e28bd8,35015,37005,8,6,1990,13,11
03ff7e51,34475,37365,9,3,2890,13,11
09724c69,34275,37725,10,9,3450,13,11
093d2aa9,34385,38085,0,9,3700,13,11
02c380d6,35485,38445,1,2,2960,13,11
03726654,35135,38805,2,3,3670,13,11
093870a3,35235,39165,3,9,3930,13,11
0a8bdf26,36095,39525,4,10,3430,13,11
0a572cf3,35885,39885,5,10,4000,13,11
09fdd2a2,36725,40245,6,9,3520,13,11
0950deb1,36425,40605,7,9,4180,13,11
0579a0b9,36735,40965,8,5,4230,13,11
020f3787,36345,41325,9,2,4980,13,11
08a4b156,37065,41685,10,8,4620,13,11
046333a5,36965,42045,0,4,5080,13,11
009650a3,35945,42405,1,0,6460,13,11
07513ae4,36565,42765,2,7,6200,13,11
06265b62,36475,43125,3,6,6650,13,11
0a2554f3,36885,43515,6,10,6630,13,11
0ac603b0,36925,43875,7,10,6950,13,11
00cd9283,135005,135385,3,0,380,13,11
0a5c4702,135005,135745,2,10,740,13,11
019837d4,135005,136105,4,1,1100,13,11
07396508,135005,136465,8,7,1460,13,11
07c4bd98,135005,136825,8,7,1820,13,11
08ec0d75,135005,137185,5,8,2180,13,11
07bf6d3a,135005,137545,10,7,2540,13,11
02617737,135005,137905,7,2,2900,13,11
0aeed561,135005,138625,1,10,3620,13,11
09cde4d3,135005,138985,3,9,3980,13,11
007c63d6,135005,139345,6,0,4340,13,11
0759f265,135005,139705,5,7,4700,13,11
05578a15,135005,140065,5,5,5060,13,11
008d14e7,135005,140425,7,0,5420,13,11
04e32497,135005,140785,7,4,5780,13,11
049e7398,135005,141145,8,4,6140,13,11
08599fa8,135005,141505,8,8,6500,13,11
00f72fd1,135005,142225,1,0,7220,13,11
0a7ca593,135005,142585,3,10,7580,13,11
00ebab49,135005,142945,9,0,7940,13,11
02fa8791,337065,337595,1,2,530,13,11
067aec74,337445,337985,4,6,540,13,11
04345ca5,337175,338345,5,4,1170,13,11
0359dba6,337575,338705,6,3,1130,13,11
0a4e3c87,337145,339065,7,10,1920,13,11
026abc48,337595,339425,8,2,1830,13,11
00fd3923,337665,339875,3,0,2210,13,11
03295b94,337655,340235,4,3,2580,13,11
09f41135,337265,340595,5,9,3330,13,11
05bddb67,337475,340965,7,5,3490,13,11
09df5fa3,438265,439015,3,9,750,13,11
09521326,438375,439405,6,9,1030,13,11
02794f28,438295,439775,8,2,1480,13,11
09e5ebd2,438455,440205,2,9,1750,13,11
05fcd846,438535,440615,6,5,2080,13,11
043cfca8,539185,539695,8,4,510,13,11
02535243,1095,1715,3,2,620,13,13
0195e819,12045,12505,5,1,460,13,13
01284651,12295,12875,7,1,580,13,13
01056637,12135,13235,8,1,1100,13,13
01f998da,12225,13595,9,1,1370,13,13
013e3016,12455,13955,10,1,1500,13,13
0197b0d8,12215,14385,2,1,2170,13,13
017cd0dc,12515,14745,3,1,2230,13,13
014d6094,12105,15115,5,1,3010,13,13
01752121,12365,15485,7,1,3120,13,13
063f1768,23105,23565,8,6,460,13,13
003d2aa8,23575,24155,8,0,580,13,13
0b2d6128,23775,24745,8,11,970,13,13
0b069f27,34105,34585,9,11,480,13,13
064f61aa,135005,135385,10,6,380,13,13
07a4ec58,135005,135745,8,7,740,13,13
0224185c,135005,136825,12,2,1820,13,13
0c25a77b,135005,137545,11,12,2540,13,13
03caf2a2,135005,137905,2,3,2900,13,13
0790b2a4,135005,138625,4,7,3620,13,13
00187795,135005,138985,5,0,3980,13,13
0037195a,135005,139345,10,0,4340,13,13
017a6fd1,135005,139705,1,1,4700,13,13
0603e969,135005,140425,9,6,5420,13,13
0214c3c6,135005,140785,6,2,5780,13,13
0879a0bb,135005,141145,11,8,6140,13,13
079a18f4,135005,141505,4,7,6500,13,13
01ccec20,135005,141865,0,1,6860,13,13
08b4b495,135005,142225,5,8,7220,13,13
028565f9,135005,142585,9,2,7580,13,13
0a1ff445,135005,142945,5,10,7940,13,13
01fb9b6c,135005,143305,12,1,8300,13,13
01b49cab,135005,143665,11,1,8660,13,13
067e408b,135005,144025,11,6,9020,13,13
09779fa0,135005,144385,0,9,9380,13,13
0aa8a293,337075,337675,3,10,600,13,13
07574c58,337165,338435,8,7,1270,13,13
0a1b4988,337255,339025,8,10,1770,13,13
03efda90,438335,438875,0,3,540,13,13
08b80a81,438265,439235,1,8,970,13,13
036c09f4,438595,439625,4,3,1030,13,13
03bb90e5,438425,439985,5,3,1560,13,13
06a8ca17,438415,440355,7,6,1940,13,13
07fb52aa,438655,440745,10,7,2090,13,13
07466e60,438505,441135,0,7,2630,13,13
00284650,34025,34425,1,0,400,3,2
013e3010,34135,34785,0,1,650,3,2
0030aca0,135005,135385,0,0,380,3,2
01572cf1,135005,135745,1,1,740,3,2
00e618a1,337065,337455,1,0,390,3,2
000f3781,539065,539475,1,0,410,3,2
04535245,1005,1575,5,4,570,16,14
0d95e81d,12065,12505,1,13,440,16,14
0df998d5,12365,12865,2,13,500,16,14
0ddcd3dc,12765,13255,5,13,490,16,14
0d28465d,12445,13615,6,13,1170,16,14
0d3f176b,12755,13985,8,13,1230,16,14
0ddf78c3,12935,14355,10,13,1420,16,14
0d7cd0d8,12705,14715,11,13,2010,16,14
0d4d609b,12165,15445,0,13,3280,16,14
0d97b0d8,12335,15805,1,13,3470,16,14
0d724c61,13075,16195,4,13,3120,16,14
0d784c56,13145,16565,6,13,3420,16,14
0dde9f91,13035,16935,8,13,3900,16,14
0d752128,12535,17725,0,13,5190,16,14
003d2aa2,23105,23525,2,0,420,16,14
06696ce2,23475,24135,2,6,660,16,14
0ca4ec52,23635,24745,2,12,1110,16,14
068495cb,34105,34625,7,6,520,16,14
07b582d1,34295,34985,8,7,690,16,14
0842120d,34495,35355,10,8,860,16,14
09726653,34305,35715,11,9,1410,16,14
07e28bd4,34205,36075,12,7,1870,16,14
060f3786,35565,36435,13,6,870,16,14
094b3410,35495,37165,2,9,1670,16,14
0c3b813c,34745,37525,3,12,2780,16,14
02c380d6,34815,37885,4,2,3070,16,14
00845aa7,34585,38245,5,0,3660,16,14
09ccc9d8,34635,38605,6,9,3970,16,14
0bb22802,34425,38965,7,11,4540,16,14
019650a0,35335,39325,8,1,3990,16,14
0dfdd2ab,35945,39685,9,13,3740,16,14
0bfdd6b4,34915,40045,10,11,5130,16,14
0c265b61,35715,40405,11,12,4690,16,14
0be618ab,35485,40765,12,11,5280,16,14
015fb4c8,36545,41125,13,1,4580,16,14
0d502bc6,35935,41485,0,13,5550,16,14
023327e1,36255,42215,3,2,5960,16,14
0033ed04,37185,42575,4,0,5390,16,14
081559f9,36645,43295,6,8,6650,16,14
064569f3,36905,44015,8,6,7110,16,14
08d60b79,36805,44375,9,8,7570,16,14
029a18f0,36705,44735,10,2,8030,16,14
00ec0d78,37235,45095,11,0,7860,16,14
01e32498,37145,45465,13,1,8320,16,14
06e37891,37115,45825,0,6,8710,16,14
08bddb65,135005,135385,5,8,380,16,14
085a8a15,135005,135745,5,8,740,16,14
0475f4b5,135005,136105,5,4,1100,16,14
0dc03738,135005,136465,8,13,1460,16,14
07e93146,135005,136825,6,7,1820,16,14
0d12f962,135005,137185,2,13,2180,16,14
072ae3f6,135005,137545,6,7,2540,16,14
0691ae67,135005,137905,7,6,2900,16,14
05f72fda,135005,138265,10,5,3260,16,14
090b7d97,135005,138625,7,9,3620,16,14
0a7e4083,135005,138985,3,10,3980,16,14
05000b93,135005,139345,3,5,4340,16,14
0b409174,135005,139705,4,11,4700,16,14
02efda94,135005,140065,4,2,5060,16,14
0c3cfcac,135005,140425,12,12,5420,16,14
034df28a,135005,140785,10,3,5780,16,14
046fae23,135005,141145,3,4,6140,16,14
01d2358b,135005,141505,11,1,6500,16,14
09a5649c,135005,141865,12,9,6860,16,14
03a595b0,135005,142225,0,3,7220,16,14
068fdf7b,135005,142585,11,6,7580,16,14
0adaddc8,135005,142945,8,10,7940,16,14
04b69db1,135005,143305,1,4,8300,16,14
02530c78,135005,143665,8,2,8660,16,14
0ae05d5a,135005,144025,10,10,9020,16,14
038d14e7,135005,144745,7,3,9740,16,14
020c96b3,135005,145105,3,2,10100,16,14
0c60d866,337085,337475,6,12,390,16,14
08321f00,337185,337965,0,8,780,16,14
02197383,539085,539545,3,2,460,16,14
00691404,539185,539905,4,0,720,16,14
0729d172,540055,540445,2,7,390,16,14
011932a6,539775,540855,6,1,1080,16,14
0014ee1d,539975,541325,13,0,1350,16,14
07831c00,539475,541685,0,7,2210,16,14
05535243,1065,1495,3,5,430,13,9
03f998d5,12185,12875,5,3,690,13,9
0397b0d4,12145,13245,7,3,1100,13,9
033e3015,12365,13605,8,3,1240,13,9
034d6090,12105,13965,0,3,1860,13,9
03056636,12135,14335,2,3,2200,13,9
03752123,12345,14765,7,3,2420,13,9
037cd0d2,12385,15175,2,3,2790,13,9
073f1761,23055,23465,1,7,410,13,9
02457ed1,23115,23975,1,2,860,13,9
08784c54,34215,34915,7,8,700,13,9
07de9f94,34135,35275,8,7,1140,13,9
053d2aa7,34275,36365,3,5,2090,13,9
06724c62,34195,36725,4,6,2530,13,9
08cdb8f0,34565,37085,5,8,2520,13,9
00696ce2,34645,37455,7,0,2810,13,9
08e28bd7,34815,38195,2,8,3380,13,9
072d6121,34495,38555,3,7,4060,13,9
02069f28,34615,38915,4,2,4300,13,9
028495c3,34805,39275,5,2,4470,13,9
082e2ed2,135005,135745,2,8,740,13,9
02f72fd5,135005,136105,5,2,1100,13,9
0563eae8,135005,136825,8,5,1820,13,9
04a4b151,135005,137545,1,4,2540,13,9
01e32494,135005,137905,4,1,2900,13,9
039e7397,135005,138265,7,3,3260,13,9
088db5a5,135005,138625,5,8,3620,13,9
05daddc3,135005,138985,3,5,3980,13,9
0665d938,135005,139345,8,6,4340,13,9
0362ad57,135005,139705,7,3,4700,13,9
030f3784,135005,140065,4,3,5060,13,9
016333a1,135005,140425,1,1,5420,13,9
05bc05b1,135005,140785,1,5,5780,13,9
015007e1,135005,141145,1,1,6140,13,9
02a0c8e1,135005,141505,1,2,6500,13,9
0872db63,337025,337415,3,8,390,13,9
04ebab46,337375,337805,6,4,430,13,9
04261f78,337295,338175,8,4,880,13,9
0349b040,337195,338535,0,3,1340,13,9
07807691,337325,338895,1,7,1570,13,9
0871a462,337145,339255,2,8,2110,13,9
04cd9285,337525,339985,5,4,2460,13,9
00530c73,337635,340795,3,0,3160,13,9
067901c7,438415,439035,7,6,620,13,9
03e07291,438395,439425,1,3,1030,13,9
06567867,539025,539515,7,6,490,13,9
0353524c,1095,1555,12,3,460,9,16
0995e813,12035,12485,8,9,450,9,16
0997b0dd,12115,12875,11,9,760,9,16
094d6090,12075,13245,13,9,1170,9,16
0905663f,12085,13605,14,9,1520,9,16
09284659,12245,14195,11,9,1950,9,16
09f998df,12175,14585,14,9,2410,9,16
0d752128,23015,23485,8,13,470,9,16
07dcd3d9,34035,34425,5,7,390,9,16
0e724c63,34305,34855,10,14,550,9,16
0cdf78c3,34235,35215,11,12,980,9,16
0fde9f9e,34245,35575,12,15,1330,9,16
0c27277b,34525,35945,14,12,1420,9,16
0dcdb8f3,34635,36305,15,13,1670,9,16
0b3d2aa8,34465,36665,0,11,2200,9,16
06784c52,34385,37025,1,6,2640,9,16
0c07ae81,34765,37385,2,12,2620,9,16
08457ed4,34135,37755,4,8,3620,9,16
0f2d612f,34555,38115,5,15,3560,9,16
0a03e961,35455,38485,7,10,3030,9,16
02572cf1,36045,38845,8,2,2800,9,16
06a4ec55,34805,39205,9,6,4400,9,16
008495cf,34905,39575,11,0,4670,9,16
0a74a023,35875,39935,12,10,4060,9,16
09726654,35075,40655,14,9,5580,9,16
0514c3cb,36305,41015,15,5,4710,9,16
0a3b813a,35555,41375,0,10,5820,9,16
05f62634,35155,41735,1,5,6580,9,16
0050debf,36655,42095,2,0,5440,9,16
0ee618a8,36455,42465,4,14,6010,9,16
01b34d88,36515,42825,5,1,6310,9,16
0863eae5,35895,43195,7,8,7300,9,16
05513aeb,36815,43555,8,5,6740,9,16
014b3415,36505,43915,9,1,7410,9,16
00bf9c64,36785,44285,11,0,7500,9,16
000f3781,36525,44645,12,0,8120,9,16
0b30aca8,36275,45005,13,11,8730,9,16
09ccec23,135005,135385,3,9,380,9,16
01bf6d3f,135005,135745,15,1,740,9,16
03a0c8e9,135005,136105,9,3,1100,9,16
0590d446,135005,136465,6,5,1460,9,16
0cae2b55,135005,136825,5,12,1820,9,16
0debc9a9,135005,137185,9,13,2180,9,16
0818779e,135005,137545,14,8,2540,9,16
044266d6,135005,137905,6,4,2900,9,16
01ebab40,135005,138265,0,1,3260,9,16
05e07293,135005,138625,3,5,3620,9,16
01ab35e2,135005,138985,2,1,3980,9,16
0461ab64,135005,139345,4,4,4340,9,16
05fdd2aa,135005,140065,10,5,5060,9,16
0699bf18,135005,140425,8,6,5420,9,16
079e739b,135005,141145,11,7,6140,9,16
00563586,135005,141505,6,0,6500,9,16
0c292b33,135005,141865,3,12,6860,9,16
0a36cdaa,135005,142225,10,10,7220,9,16
0ffcf0e4,135005,142585,4,15,7580,9,16
07fb9b65,135005,142945,5,7,7940,9,16
01cde4d3,135005,143305,3,1,8300,9,16
00261f78,135005,143665,8,0,8660,9,16
0d1451cc,135005,144025,12,13,9020,9,16
0f504738,135005,144385,8,15,9380,9,16
01921c04,135005,144745,4,1,9740,9,16
023b6cf6,135005,145105,6,2,10100,9,16
02488355,135005,145465,5,2,10460,9,16
0e3327eb,135005,145825,11,14,10820,9,16
0ed60b71,135005,146185,1,14,11180,9,16
0012f967,135005,146545,7,0,11540,9,16
07b80a8e,337105,337635,14,7,530,9,16
07efda95,337155,338445,5,7,1290,9,16
0e466e66,337305,338805,6,14,1500,9,16
01a8ca19,337185,339195,9,1,2010,9,16
05a1d2a3,438175,438565,3,5,390,9,16
025f48dd,438275,439095,13,2,820,9,16
05fb52af,438155,439465,15,5,1310,9,16
00535242,1035,1495,2,0,460,6,5
0095e810,12045,12445,4,0,400,6,5
0397b0d2,23215,23935,2,3,720,6,5
04284652,34105,34475,0,4,370,6,5
043e3014,34275,34865,3,4,590,6,5
00752121,34205,35225,4,0,1020,6,5
04df78c0,34625,35945,1,4,1320,6,5
01ff7e52,34985,36305,2,1,1320,6,5
00069f23,35165,37025,4,0,1860,6,5
0407ae84,35195,37385,0,4,2190,6,5
023870a1,35695,37745,1,2,2050,6,5
02449231,36415,38465,3,2,2050,6,5
00069f23,35165,38825,4,0,3660,6,5
023870a1,35695,39545,1,2,3850,6,5
04bf9c61,135005,135385,1,4,380,6,5
0499bf14,135005,136105,4,4,1100,6,5
02da9f84,135005,136465,4,2,1460,6,5
044b3412,135005,136825,2,4,1820,6,5
0079a0b0,135005,137185,0,0,2180,6,5
043327e0,135005,137545,0,4,2540,6,5
021559f0,135005,137905,0,2,2900,6,5
01bc05b2,135005,138265,2,1,3260,6,5
0150deb1,135005,138625,1,1,3620,6,5
02ec0d70,337045,337455,0,2,410,6,5
0112f962,438135,438525,2,1,390,6,5
02d7f0c1,438205,438935,1,2,730,6,5
00ccec22,438285,439295,2,0,1010,6,5
0025a771,539195,539665,1,0,470,6,5
01535249,1005,1535,9,1,530,11,10
0895e813,12075,12465,5,8,390,11,10
0897b0d8,12245,13225,0,8,980,11,10
084d6094,12155,13585,1,8,1430,11,10
08f998d3,12295,13975,4,8,1680,11,10
08284659,12335,14335,5,8,2000,11,10
023e3014,23045,23445,4,2,400,11,10
02724c64,23425,23975,4,2,550,11,10
01272777,34185,34815,5,1,630,11,10
032d6120,34205,35175,6,3,970,11,10
00cdb8f9,34215,35545,8,0,1330,11,10
03ff7e55,34175,35905,9,3,1730,11,10
04b582d4,34605,36265,0,4,1660,11,10
083d2aa3,34155,36625,1,8,2470,11,10
04a4ec50,34415,36985,2,4,2570,11,10
0607ae85,34365,37345,3,6,2980,11,10
00421208,34885,37705,4,0,2820,11,10
0203e963,35085,38065,5,2,2980,11,10
02265b69,36075,38425,6,2,2350,11,10
0514c3c1,35695,38785,7,5,3090,11,10
07b22805,34835,39505,9,7,4670,11,10
040f3780,35955,39865,0,4,3910,11,10
03e28bd1,34555,40585,2,3,6030,11,10
0250deb0,35995,40945,3,2,4950,11,10
016333a5,36555,41305,4,1,4750,11,10
07c4bd93,36755,41665,5,7,4910,11,10
03a4b154,36625,42025,6,3,5400,11,10
08fdd2a2,36375,42385,7,8,6010,11,10
063327e8,36585,43105,9,6,6520,11,10
057be716,36405,43465,0,5,7060,11,10
079e7393,135005,135745,3,7,740,11,10
01a0c8e8,135005,136105,8,1,1100,11,10
03b36cb6,135005,136465,6,3,1460,11,10
0140cd02,135005,136825,2,1,1820,11,10
031340a0,135005,137185,0,3,2180,11,10
040b7d96,135005,137545,6,4,2540,11,10
0018d884,135005,137905,4,0,2900,11,10
08408da7,135005,138265,7,8,3260,11,10
065007e2,135005,138985,2,6,3980,11,10
03563584,135005,139345,4,3,4340,11,10
06119792,135005,140065,2,6,5060,11,10
029e94e8,135005,140425,8,2,5420,11,10
01b69db3,135005,140785,3,1,5780,11,10
06807699,135005,141145,9,6,6140,11,10
067901c5,135005,141505,5,6,6500,11,10
064f61a4,135005,141865,4,6,6860,11,10
02e32497,135005,142225,7,2,7220,11,10
0561ab64,337015,337435,4,5,420,11,10
053ff786,337255,337805,6,5,550,11,10
019837d8,337055,338175,8,1,1120,11,10
07f0fdc9,337135,338535,9,7,1400,11,10
05157862,337185,339265,2,5,2080,11,10
09d2b797,438095,438545,7,9,450,11,10
023b6cf0,438055,438935,0,2,880,11,10
088e4fa2,539025,539405,2,8,380,11,10
00a8a293,539395,539915,3,0,520,11,10
03574c54,539505,540275,4,3,770,11,10
08578a10,539115,540725,0,8,1610,11,10
06535240,1095,1555,0,6,460,9,10
0595e810,12105,12505,7,5,400,9,10
054d6098,12205,12865,8,5,660,9,10
05056635,12215,13295,3,5,1080,9,10
0297b0d6,23085,23485,6,2,400,9,10
09284656,23185,24015,6,9,830,9,10
03752125,34025,34485,6,3,460,9,10
063e3017,34035,34855,8,6,820,9,10
023f1764,34125,35215,9,2,1090,9,10
02272779,34635,35575,0,2,940,9,10
047cd0d8,34095,36295,2,4,2200,9,10
0607ae86,34835,36655,3,6,1820,9,10
07ff7e58,34535,37375,5,7,2840,9,10
093d2aa4,34435,37735,6,9,3300,9,10
03a4ec52,34865,38095,7,3,3230,9,10
05724c68,34325,38455,8,5,4130,9,10
05b582d7,35075,38815,9,5,3740,9,10
023870a9,35225,39175,0,2,3950,9,10
0403e963,35505,39535,1,4,4030,9,10
088bdf24,36265,39895,2,8,3630,9,10
088495c1,34965,40255,3,8,5290,9,10
00502bc4,36945,40975,5,0,4030,9,10
05e618a3,36315,41335,6,5,5020,9,10
017be716,37225,42055,8,1,4830,9,10
0379a0b6,37135,42415,9,3,5280,9,10
01265b62,36665,42775,0,1,6110,9,10
06fdd2a6,37045,43135,1,6,6090,9,10
088bdf24,36265,43495,2,8,7230,9,10
021559f4,135005,135385,4,2,380,9,10
0433ed00,135005,135745,0,4,740,9,10
04cdb121,135005,136105,1,4,1100,9,10
05b4b494,135005,136465,4,5,1460,9,10
06617736,135005,136825,6,6,1820,9,10
088db5a3,135005,137185,3,8,2180,9,10
0340cd07,135005,137545,7,3,2540,9,10
079e94e9,135005,137905,9,7,2900,9,10
08f2c047,135005,138265,7,8,3260,9,10
052554f6,135005,138625,6,5,3620,9,10
06e37899,135005,138985,9,6,3980,9,10
0125a776,135005,139345,6,1,4340,9,10
09488781,135005,139705,1,9,4700,9,10
05599fa7,135005,140065,7,5,5060,9,10
04b36cb6,135005,140425,6,4,5420,9,10
05119791,135005,140785,1,5,5780,9,10
014bf946,135005,141505,6,1,6500,9,10
01b49ca1,135005,141865,1,1,6860,9,10
08307622,135005,142225,2,8,7220,9,10
030042d4,337045,337435,4,3,390,9,10
03530c75,337065,337795,5,3,730,9,10
067a6fd8,337235,338185,8,6,950,9,10
021451c9,337195,338545,9,2,1350,9,10
057e4081,337155,338915,1,5,1760,9,10
02e07293,337255,339285,3,2,2030,9,10
00c9c2e4,337115,339645,4,0,2530,9,10
087901c9,337315,340075,9,8,2760,9,10
02408da8,539125,539635,8,2,510,9,10
00535247,1065,1595,7,0,530,8,11
0995e816,12105,12505,2,9,400,8,11
0997b0d1,12275,12875,4,9,600,8,11
094d6094,12155,13285,8,9,1130,8,11
09056638,12175,14035,1,9,1860,8,11
0a284655,23055,23565,5,10,510,8,11
063e3015,23165,24115,5,6,950,8,11
097cd0d1,34105,34565,5,9,460,8,11
01df78c6,34325,34925,6,1,600,8,11
0a784c55,34395,35285,7,10,890,8,11
013f1761,34155,35645,8,1,1490,8,11
02f62637,35095,36015,10,2,920,8,11
06457ed1,34245,36375,0,6,2130,8,11
07724c62,34375,36735,1,7,2360,8,11
04dcd3d9,34225,37095,2,4,2870,8,11
09272779,34535,37815,4,9,3280,8,11
0230aca6,36165,38175,5,2,2010,8,11
08696ce1,34755,38535,6,8,3780,8,11
00a4ec57,34845,38895,7,0,4050,8,11
01ccc9d4,35355,39255,8,1,3900,8,11
05fdd6ba,35675,39615,9,5,3940,8,11
08fe91d6,35975,40345,1,8,4370,8,11
004b3417,36425,40705,2,0,4280,8,11
079650a0,36135,41065,3,7,4930,8,11
01502bc8,36865,41425,4,1,4560,8,11
06265b60,36665,41785,5,6,5120,8,11
02572cf2,35985,42145,6,2,6160,8,11
0291ae64,135005,135385,4,2,380,8,11
04119795,135005,135745,5,4,740,8,11
00f72fda,135005,136105,10,0,1100,8,11
04187794,135005,136465,4,4,1460,8,11
0a79a0b8,135005,136825,8,10,1820,8,11
0499bf13,135005,137185,3,4,2180,8,11
094569f3,135005,137545,3,9,2540,8,11
0512f961,135005,137905,1,5,2900,8,11
055816d3,135005,138265,3,5,3260,8,11
09617735,135005,138985,5,9,3980,8,11
03ae2b56,135005,139345,6,3,4340,8,11
04daddc1,135005,139705,1,4,4700,8,11
07fb9b63,135005,140065,3,7,5060,8,11
013327ea,135005,140785,10,1,5780,8,11
05da9f88,135005,141145,8,5,6140,8,11
03ec0d72,135005,141505,2,3,6500,8,11
09cdb128,135005,141865,8,9,6860,8,11
06a595b0,135005,142225,0,6,7220,8,11
09599fa3,135005,142585,3,9,7580,8,11
038fdf73,135005,142945,3,3,7940,8,11
0471a467,337075,337495,7,4,420,8,11
01371958,337035,337855,8,1,820,8,11
06cd928a,337415,338225,10,6,810,8,11
0949b044,337085,338655,4,9,1570,8,11
08261f75,337135,339015,5,8,1880,8,11
0818d887,337315,339385,7,8,2070,8,11
06ebab48,337245,339745,8,6,2500,8,11
01807695,337225,340235,5,1,3010,8,11
00c9c2e4,438225,438725,4,0,500,8,11
08e07297,438465,439115,7,8,650,8,11
031451c8,438375,439475,8,3,1100,8,11
067e4080,438295,439865,0,6,1570,8,11
017901c0,438525,440415,0,1,1890,8,11
08ea7667,539305,539795,7,8,490,8,11
01535249,1015,1535,9,1,520,2,10
0295e813,12025,12565,0,2,540,2,10
09056632,23105,23605,2,9,500,2,10
09f998d1,34075,34465,5,9,390,2,10
01dcd3d0,34375,34825,6,1,450,2,10
01724c66,34555,35185,7,1,630,2,10
057cd0d0,34235,35545,8,5,1310,2,10
05cdb8f2,34885,35905,9,5,1020,2,10
083e3019,34165,36265,0,8,2100,2,10
05df78c3,34485,36625,1,5,2140,2,10
00752122,34155,36985,2,0,2830,2,10
03284659,34105,37705,4,3,3600,2,10
013f1763,34325,38065,5,1,3740,2,10
02de9f91,34525,38425,6,2,3900,2,10
0407ae82,34985,38785,7,4,3800,2,10
052d6126,34875,39145,8,5,4270,2,10
093d2aa1,34675,39515,0,9,4840,2,10
06069f26,34895,39875,1,6,4980,2,10
06457ed1,34475,40235,2,6,5760,2,10
06f62636,35375,40605,4,6,5230,2,10
013f1763,34325,40965,5,1,6640,2,10
02de9f91,34525,41325,6,2,6800,2,10
0407ae82,34985,41685,7,4,6700,2,10
0562ad57,135005,135385,7,5,380,2,10
0663eae8,135005,135745,8,6,740,2,10
04572cf8,135005,136105,8,4,1100,2,10
029650a9,135005,136465,9,2,1460,2,10
0814c3c0,135005,136825,0,8,1820,2,10
00b34d83,135005,137545,3,0,2540,2,10
05a12890,135005,137905,0,5,2900,2,10
04265b65,135005,138265,5,4,3260,2,10
037d6539,135005,138625,9,3,3620,2,10
09fdd2a5,539125,539585,5,9,460,2,10
0a535244,1095,1635,4,10,540,16,12
0b4d6090,12095,12485,8,11,390,16,12
0b95e819,12015,12855,10,11,840,16,12
0b3e3012,12535,13605,2,11,1070,16,12
0b28465a,12375,13965,3,11,1590,16,12
0b056633,12135,14355,6,11,2220,16,12
0bdcd3d6,12785,14715,7,11,1930,16,12
0b3f1769,12695,15105,10,11,2410,16,12
0b7cd0d4,12625,15535,3,11,2910,16,12
0b97b0d1,12195,15925,6,11,3730,16,12
00457ed3,23035,23625,3,0,590,16,12
01d60b74,135005,135385,4,1,380,16,12
075007e9,135005,135745,9,7,740,16,12
0adbc26b,135005,136105,11,10,1100,16,12
02e94df4,135005,136465,4,2,1460,16,12
01e8a381,135005,136825,1,1,1820,16,12
0749b048,135005,137185,8,7,2180,16,12
027c63d6,135005,137545,6,2,2540,16,12
08726654,135005,138625,4,8,3620,16,12
09572cf8,135005,138985,8,9,3980,16,12
00fdd2a6,135005,139345,6,0,4340,16,12
062ed3d1,135005,139705,1,6,4700,16,12
01ff29c9,135005,140065,9,1,5060,16,12
09fb6656,135005,140425,6,9,5420,16,12
001340a5,135005,140785,5,0,5780,16,12
08371954,135005,141145,4,8,6140,16,12
05567867,135005,141505,7,5,6500,16,12
0861ab6a,135005,141865,10,8,6860,16,12
01488355,135005,142225,5,1,7220,16,12
0afb52a0,135005,142585,0,10,7580,16,12
0363eae3,135005,142945,3,3,7940,16,12
0a513ae8,135005,143305,8,10,8300,16,12
019a18f2,135005,143665,2,1,8660,16,12
054e3c81,337075,337615,1,5,540,16,12
077aec74,438215,438645,4,7,430,16,12
086abc49,438415,439075,9,8,660,16,12
0a59dba0,438325,439465,0,10,1140,16,12
01bddb63,438305,439855,3,1,1550,16,12
05df5fa7,539265,539755,7,5,490,16,12
07535242,1015,1475,2,7,460,15,9
0897b0d7,12115,12505,3,8,390,15,9
08752122,12335,12865,4,8,530,15,9
0895e816,12065,13225,5,8,1160,15,9
084d6090,12075,13585,6,8,1510,15,9
08056631,12095,13945,7,8,1850,15,9
083e3016,12385,14675,1,8,2290,15,9
08284650,12285,15035,2,8,2750,15,9
08de9f96,12715,15405,4,8,2690,15,9
083f1766,12535,15765,5,8,3230,15,9
08f998d2,12215,16125,6,8,3910,15,9
08724c62,12785,16485,7,8,3700,15,9
08df78c0,12635,17215,1,8,4580,15,9
06784c58,23065,23605,8,6,540,15,9
0407ae88,23545,24115,8,4,570,15,9
01f62635,34115,34585,7,1,470,15,9
02421206,34165,34945,8,2,780,15,9
04726652,34085,35305,0,4,1220,15,9
03a12895,35195,35665,1,3,470,15,9
003870a0,34135,36025,2,0,1890,15,9
08845aa3,34255,36385,3,8,2130,15,9
033b8135,34395,36745,4,3,2350,15,9
00ccc9d0,34315,37105,5,0,2790,15,9
0362ad57,34645,37465,6,3,2820,15,9
04c380d6,34465,37825,7,4,3360,15,9
079650a4,34925,38185,8,7,3260,15,9
0830aca3,34985,38545,0,8,3560,15,9
07d60b77,36545,38905,1,7,2360,15,9
043327e1,35905,39265,2,4,3360,15,9
01b34d84,35155,39625,3,1,4470,15,9
064569f8,36555,40345,5,6,3790,15,9
04da9f81,36535,40705,6,4,4170,15,9
00502bc3,35445,41065,7,0,5620,15,9
02d945c6,36585,41425,8,2,4840,15,9
02241850,35715,41785,0,2,6070,15,9
0533ed02,36855,42145,1,5,5290,15,9
045c4708,135005,135385,8,4,380,15,9
01175c10,135005,136105,0,1,1100,15,9
067fc516,135005,136465,6,6,1460,15,9
05a595b3,135005,136825,3,5,1820,15,9
006adab0,135005,137545,0,0,2540,15,9
0165d930,135005,137905,0,1,2900,15,9
01ebab40,135005,138265,0,1,3260,15,9
089837d4,135005,138625,4,8,3620,15,9
02488352,135005,138985,2,2,3980,15,9
0592f850,135005,139705,0,5,4700,15,9
05292b33,135005,140065,3,5,5060,15,9
0440cd03,135005,140425,3,4,5420,15,9
00bc4b88,135005,140785,8,0,5780,15,9
07261f71,135005,141145,1,7,6140,15,9
047c63d7,135005,141505,7,4,6500,15,9
055ff9e6,337085,337475,6,5,390,15,9
054e3c88,337365,337845,8,5,480,15,9
07de6381,337165,338215,1,7,1050,15,9
03fa8792,337265,338575,2,3,1310,15,9
06345ca0,438105,438635,0,6,530,15,9
00f41132,438145,439005,2,0,860,15,9
04295b91,539445,539995,1,4,550,15,9
074d6097,12095,12475,1,7,380,15,9
0795e810,12035,12835,2,7,800,15,9
07752125,12395,13195,3,7,800,15,9
07f998d6,12225,13555,4,7,1330,15,9
073e3011,12455,13915,5,7,1460,15,9
073f1768,12575,14275,6,7,1700,15,9
07284656,12305,14645,8,7,2340,15,9
07056637,12155,15015,1,7,2860,15,9
0797b0d1,12175,15375,2,7,3200,15,9
077cd0d8,12525,15745,4,7,3220,15,9
07dcd3d8,12635,16155,8,7,3520,15,9
07457ed4,23055,23525,4,7,470,15,9
03784c55,34085,34545,5,3,460,15,9
073d2aa4,34115,34935,8,7,820,15,9
06ff7e51,34205,35345,3,6,1140,15,9
08617730,135005,135385,0,8,380,15,9
08e94df2,135005,135745,2,8,740,15,9
00fb9b64,135005,136105,4,0,1100,15,9
042d6128,135005,136465,8,4,1460,15,9
05ccc9d0,135005,136825,0,5,1820,15,9
048bdf23,135005,137185,3,4,2180,15,9
022554f7,135005,137545,7,2,2540,15,9
01bc05b2,135005,137905,2,1,2900,15,9
049e7395,135005,138265,5,4,3260,15,9
01fb6657,135005,138625,7,1,3620,15,9
01976671,135005,138985,1,1,3980,15,9
02b49ca0,135005,139345,0,2,4340,15,9
05421207,135005,139705,7,5,4700,15,9
007be717,135005,140425,7,0,5420,15,9
064569f7,135005,140785,7,6,5780,15,9
015007e5,135005,141145,5,1,6140,15,9
01599fa0,135005,141505,0,1,6500,15,9
05ebab47,337045,337495,7,5,450,15,9
0818d881,337065,337885,1,8,820,15,9
000042d4,438125,438555,4,0,430,15,9
03c9c2e6,438315,438925,6,3,610,15,9
08530c70,438215,439315,0,8,1100,15,9
00e07298,539305,539895,8,0,590,15,9
