Package,t_envio,t_recibido,emisor,receptor,latencia,p_fifo
0004128d,105,525,9,3,420,16
0004128d,105,525,9,3,420,16
0002e120,100275,100355,2,1,80,16
0002ce61,100305,100615,8,1,310,16
00011274,100395,100695,6,0,300,16
0002ad23,100485,100915,8,1,430,16
0004128d,105,525,9,3,420,16
0002e120,100275,100355,2,1,80,16
0002ce61,100305,100615,8,1,310,16
00011274,100395,100695,6,0,300,16
0002ad23,100485,100915,8,1,430,16
00047501,200435,200475,3,3,40,16
00030062,200375,200595,14,2,220,16
000445cd,200455,200625,15,3,170,16
000344d6,200575,200805,13,2,230,16
0003c954,200495,200865,14,2,370,16
0004fb27,200755,200995,11,3,240,16
000116fc,200925,201015,1,0,90,16
00044462,200665,201035,4,3,370,16
00022ebb,200825,201065,9,1,240,16
0002f800,200955,201215,12,1,260,16
00024e85,201005,201255,6,1,250,16
000291d5,201215,201315,1,1,100,16
00040f2e,200875,201385,7,3,510,16
00018c99,201065,201465,9,0,400,16
00010bb9,201245,201595,12,0,350,16
000476df,201155,201715,9,3,560,16
0004128d,105,525,9,3,420,16
0002e120,100275,100355,2,1,80,16
0002ce61,100305,100615,8,1,310,16
00011274,100395,100695,6,0,300,16
0002ad23,100485,100915,8,1,430,16
00047501,200435,200475,3,3,40,16
00030062,200375,200595,14,2,220,16
000445cd,200455,200625,15,3,170,16
000344d6,200575,200805,13,2,230,16
0003c954,200495,200865,14,2,370,16
0004fb27,200755,200995,11,3,240,16
000116fc,200925,201015,1,0,90,16
00044462,200665,201035,4,3,370,16
00022ebb,200825,201065,9,1,240,16
0002f800,200955,201215,12,1,260,16
00024e85,201005,201255,6,1,250,16
000291d5,201215,201315,1,1,100,16
00040f2e,200875,201385,7,3,510,16
00018c99,201065,201465,9,0,400,16
00010bb9,201245,201595,12,0,350,16
000476df,201155,201715,9,3,560,16
0001adbf,300405,300705,14,0,300,16
00022e54,300425,300705,9,1,280,16
00036668,300625,300765,12,2,140,16
0001c5f9,300675,300785,4,0,110,16
00025c7d,300405,300785,5,1,380,16
0002f20c,300515,300865,13,1,350,16
00036386,300865,300965,3,2,100,16
000290bf,300765,301005,6,1,240,16
0004c54b,300605,301015,5,3,410,16
00031326,300765,301025,1,2,260,16
0003601c,300945,301215,10,2,270,16
00047d21,300765,301225,1,3,460,16
00046dc6,301025,301345,4,3,320,16
0004e6b0,300815,301445,7,3,630,16
0004128d,105,525,9,3,420,16
0002e120,100275,100355,2,1,80,16
0002ce61,100305,100615,8,1,310,16
00011274,100395,100695,6,0,300,16
0002ad23,100485,100915,8,1,430,16
00047501,200435,200475,3,3,40,16
00030062,200375,200595,14,2,220,16
000445cd,200455,200625,15,3,170,16
000344d6,200575,200805,13,2,230,16
0003c954,200495,200865,14,2,370,16
0004fb27,200755,200995,11,3,240,16
000116fc,200925,201015,1,0,90,16
00044462,200665,201035,4,3,370,16
00022ebb,200825,201065,9,1,240,16
0002f800,200955,201215,12,1,260,16
00024e85,201005,201255,6,1,250,16
000291d5,201215,201315,1,1,100,16
00040f2e,200875,201385,7,3,510,16
00018c99,201065,201465,9,0,400,16
00010bb9,201245,201595,12,0,350,16
000476df,201155,201715,9,3,560,16
0001adbf,300405,300705,14,0,300,16
00022e54,300425,300705,9,1,280,16
00036668,300625,300765,12,2,140,16
0001c5f9,300675,300785,4,0,110,16
00025c7d,300405,300785,5,1,380,16
0002f20c,300515,300865,13,1,350,16
00036386,300865,300965,3,2,100,16
000290bf,300765,301005,6,1,240,16
0004c54b,300605,301015,5,3,410,16
00031326,300765,301025,1,2,260,16
0003601c,300945,301215,10,2,270,16
00047d21,300765,301225,1,3,460,16
00046dc6,301025,301345,4,3,320,16
0004e6b0,300815,301445,7,3,630,16
0003102e,400585,400665,3,2,80,16
000236ac,400645,400825,4,1,180,16
000103ff,400695,400915,13,0,220,16
000336f8,400695,400975,0,2,280,16
0002ffc5,400825,401105,3,1,280,16
0003c4e1,401025,401115,1,2,90,16
0001de1c,400975,401195,5,0,220,16
0002d45b,401075,401225,2,1,150,16
000403eb,400765,401225,7,3,460,16
000390ca,400875,401235,6,2,360,16
0003d6dc,400965,401435,7,2,470,16
00013d02,401125,401605,15,0,480,16
00037ff3,165,385,14,2,220,23
00037ff3,165,385,14,2,220,23
0004843b,100375,100415,3,3,40,23
0004d309,100425,100525,3,3,100,23
00032ad0,100215,100535,5,2,320,23
000105e9,100375,100575,5,0,200,23
00025478,100235,100575,5,1,340,23
00035ecd,100295,100575,4,2,280,23
0003edcc,100555,100615,2,2,60,23
000118b7,100285,100695,11,0,410,23
0002a461,100455,100715,14,1,260,23
0001c51e,100665,100735,4,0,70,23
00048c35,100585,100745,13,3,160,23
00047062,100625,100785,1,3,160,23
0003df60,100635,100885,14,2,250,23
0002a983,100535,100895,10,1,360,23
00031b7d,100455,100925,7,2,470,23
00020348,100585,100935,8,1,350,23
0003b460,100755,101125,11,2,370,23
00037ff3,165,385,14,2,220,23
0004843b,100375,100415,3,3,40,23
0004d309,100425,100525,3,3,100,23
00032ad0,100215,100535,5,2,320,23
000105e9,100375,100575,5,0,200,23
00025478,100235,100575,5,1,340,23
00035ecd,100295,100575,4,2,280,23
0003edcc,100555,100615,2,2,60,23
000118b7,100285,100695,11,0,410,23
0002a461,100455,100715,14,1,260,23
0001c51e,100665,100735,4,0,70,23
00048c35,100585,100745,13,3,160,23
00047062,100625,100785,1,3,160,23
0003df60,100635,100885,14,2,250,23
0002a983,100535,100895,10,1,360,23
00031b7d,100455,100925,7,2,470,23
00020348,100585,100935,8,1,350,23
0003b460,100755,101125,11,2,370,23
0001bd2b,200385,200605,6,0,220,23
0001bdd3,200485,200695,12,0,210,23
00022f31,200715,200755,1,1,40,23
00037ff3,165,385,14,2,220,23
0004843b,100375,100415,3,3,40,23
0004d309,100425,100525,3,3,100,23
00032ad0,100215,100535,5,2,320,23
000105e9,100375,100575,5,0,200,23
00025478,100235,100575,5,1,340,23
00035ecd,100295,100575,4,2,280,23
0003edcc,100555,100615,2,2,60,23
000118b7,100285,100695,11,0,410,23
0002a461,100455,100715,14,1,260,23
0001c51e,100665,100735,4,0,70,23
00048c35,100585,100745,13,3,160,23
00047062,100625,100785,1,3,160,23
0003df60,100635,100885,14,2,250,23
0002a983,100535,100895,10,1,360,23
00031b7d,100455,100925,7,2,470,23
00020348,100585,100935,8,1,350,23
0003b460,100755,101125,11,2,370,23
0001bd2b,200385,200605,6,0,220,23
0001bdd3,200485,200695,12,0,210,23
00022f31,200715,200755,1,1,40,23
00028342,200445,200895,14,1,450,23
0002ecf0,200545,200995,10,1,450,23
000207b5,200825,201055,4,1,230,23
00015ac3,200755,201085,9,0,330,23
00031cf6,200995,201145,1,2,150,23
00019ca1,200525,201185,15,0,660,23
00036a38,200925,201245,7,2,320,23
0002463b,200625,201275,3,1,650,23
00030ff9,201195,201305,3,2,110,23
0003282c,201015,201345,15,2,330,23
000367e7,200855,201385,4,2,530,23
00029801,200485,201415,14,1,930,23
00015451,201145,201425,1,0,280,23
0004a7c0,201035,201495,1,3,460,23
000151ee,201385,201555,5,0,170,23
00028cc0,201015,201595,6,1,580,23
0001cb41,200805,201635,13,0,830,23
0002f266,201325,201655,11,1,330,23
00032d4b,201275,201685,10,2,410,23
0004f495,201055,201695,5,3,640,23
000273d7,201425,201775,10,1,350,23
000407f1,201195,201815,0,3,620,23
0001ac2a,201085,201825,10,0,740,23
0003ffcc,201155,201905,5,2,750,23
000494c4,300435,300555,2,3,120,23
0003493b,300615,300715,1,2,100,23
0004d7ea,300665,300835,14,3,170,23
000328df,300725,300845,12,2,120,23
0001ec47,300685,300905,5,0,220,23
00038126,300535,300905,8,2,370,23
00047186,300925,301015,12,3,90,23
00018aee,300525,301025,7,0,500,23
0004a076,300725,301055,4,3,330,23
0003ea94,300905,301135,1,2,230,23
00028a00,300835,301245,8,1,410,23
0003136e,300815,301255,4,2,440,23
0001f7c1,300795,301375,15,0,580,23
00048f1d,300935,301385,1,3,450,23
00045dc1,300905,301465,8,3,560,23
00037ff3,165,385,14,2,220,23
0004843b,100375,100415,3,3,40,23
0004d309,100425,100525,3,3,100,23
00032ad0,100215,100535,5,2,320,23
000105e9,100375,100575,5,0,200,23
00025478,100235,100575,5,1,340,23
00035ecd,100295,100575,4,2,280,23
0003edcc,100555,100615,2,2,60,23
000118b7,100285,100695,11,0,410,23
0002a461,100455,100715,14,1,260,23
0001c51e,100665,100735,4,0,70,23
00048c35,100585,100745,13,3,160,23
00047062,100625,100785,1,3,160,23
0003df60,100635,100885,14,2,250,23
0002a983,100535,100895,10,1,360,23
00031b7d,100455,100925,7,2,470,23
00020348,100585,100935,8,1,350,23
0003b460,100755,101125,11,2,370,23
0001bd2b,200385,200605,6,0,220,23
0001bdd3,200485,200695,12,0,210,23
00022f31,200715,200755,1,1,40,23
00028342,200445,200895,14,1,450,23
0002ecf0,200545,200995,10,1,450,23
000207b5,200825,201055,4,1,230,23
00015ac3,200755,201085,9,0,330,23
00031cf6,200995,201145,1,2,150,23
00019ca1,200525,201185,15,0,660,23
00036a38,200925,201245,7,2,320,23
0002463b,200625,201275,3,1,650,23
00030ff9,201195,201305,3,2,110,23
0003282c,201015,201345,15,2,330,23
000367e7,200855,201385,4,2,530,23
00029801,200485,201415,14,1,930,23
00015451,201145,201425,1,0,280,23
0004a7c0,201035,201495,1,3,460,23
000151ee,201385,201555,5,0,170,23
00028cc0,201015,201595,6,1,580,23
0001cb41,200805,201635,13,0,830,23
0002f266,201325,201655,11,1,330,23
00032d4b,201275,201685,10,2,410,23
0004f495,201055,201695,5,3,640,23
000273d7,201425,201775,10,1,350,23
000407f1,201195,201815,0,3,620,23
0001ac2a,201085,201825,10,0,740,23
0003ffcc,201155,201905,5,2,750,23
000494c4,300435,300555,2,3,120,23
0003493b,300615,300715,1,2,100,23
0004d7ea,300665,300835,14,3,170,23
000328df,300725,300845,12,2,120,23
0001ec47,300685,300905,5,0,220,23
00038126,300535,300905,8,2,370,23
00047186,300925,301015,12,3,90,23
00018aee,300525,301025,7,0,500,23
0004a076,300725,301055,4,3,330,23
0003ea94,300905,301135,1,2,230,23
00028a00,300835,301245,8,1,410,23
0003136e,300815,301255,4,2,440,23
0001f7c1,300795,301375,15,0,580,23
00048f1d,300935,301385,1,3,450,23
00045dc1,300905,301465,8,3,560,23
00023e6c,400575,400695,0,1,120,23
00015c7b,400625,400705,4,0,80,23
0001f387,400615,400945,14,0,330,23
0004fac8,400645,401115,8,3,470,23
0004914b,115,575,6,3,460,3
0004914b,115,575,6,3,460,3
00031db6,100235,100335,12,2,100,3
0004e77e,100335,100475,14,3,140,3
0002564a,100235,100505,5,1,270,3
00048062,100355,100515,1,3,160,3
000405b2,100325,100615,2,3,290,3
00039208,100305,100665,9,2,360,3
0001ece5,100455,100715,8,0,260,3
0003054b,100615,100775,0,2,160,3
00018544,100395,100805,11,0,410,3
0002c608,100535,100845,9,1,310,3
000395d8,100555,100975,6,2,420,3
0002411a,100685,101055,10,1,370,3
00034271,100835,101145,10,2,310,3
0002332c,100785,101195,7,1,410,3
0001065f,100985,101215,12,0,230,3
0004b17c,100735,101235,6,3,500,3
00011e08,101055,101315,12,0,260,3
000382d1,100895,101405,6,2,510,3
000223f4,101135,101425,14,1,290,3
000171ac,101005,101435,11,0,430,3
0002ca20,101015,101465,7,1,450,3
00042fd6,100985,101475,7,3,490,3
00038b98,101075,101485,10,2,410,3
0003fa42,101595,101675,12,2,80,3
0004572b,101305,101705,0,3,400,3
0003b135,101305,101735,7,2,430,3
0003e497,101265,101795,11,2,530,3
0002298a,101525,101865,13,1,340,3
00043fc8,101265,101885,9,3,620,3
0004b3c5,101455,101925,4,3,470,3
0002f2db,101385,101965,11,1,580,3
0003b135,101305,101975,7,2,670,3
0004914b,115,575,6,3,460,3
00031db6,100235,100335,12,2,100,3
0004e77e,100335,100475,14,3,140,3
0002564a,100235,100505,5,1,270,3
00048062,100355,100515,1,3,160,3
000405b2,100325,100615,2,3,290,3
00039208,100305,100665,9,2,360,3
0001ece5,100455,100715,8,0,260,3
0003054b,100615,100775,0,2,160,3
00018544,100395,100805,11,0,410,3
0002c608,100535,100845,9,1,310,3
000395d8,100555,100975,6,2,420,3
0002411a,100685,101055,10,1,370,3
00034271,100835,101145,10,2,310,3
0002332c,100785,101195,7,1,410,3
0001065f,100985,101215,12,0,230,3
0004b17c,100735,101235,6,3,500,3
00011e08,101055,101315,12,0,260,3
000382d1,100895,101405,6,2,510,3
000223f4,101135,101425,14,1,290,3
000171ac,101005,101435,11,0,430,3
0002ca20,101015,101465,7,1,450,3
00042fd6,100985,101475,7,3,490,3
00038b98,101075,101485,10,2,410,3
0003fa42,101595,101675,12,2,80,3
0004572b,101305,101705,0,3,400,3
0003b135,101305,101735,7,2,430,3
0003e497,101265,101795,11,2,530,3
0002298a,101525,101865,13,1,340,3
00043fc8,101265,101885,9,3,620,3
0004b3c5,101455,101925,4,3,470,3
0002f2db,101385,101965,11,1,580,3
0003b135,101305,101975,7,2,670,3
000326f4,200525,200565,2,2,40,3
000480c2,200475,200655,14,3,180,3
00019c5c,200355,200665,8,0,310,3
000387e7,200395,200695,5,2,300,3
00016fca,200615,200725,0,0,110,3
0002090f,200655,200855,5,1,200,3
00023d1c,200785,200895,4,1,110,3
00040281,200355,200915,6,3,560,3
0001440d,200695,201085,11,0,390,3
000493d8,201105,201175,12,3,70,3
00012004,200945,201185,5,0,240,3
000406d9,200875,201215,11,3,340,3
0002137b,201095,201355,5,1,260,3
0001d671,201165,201485,13,0,320,3
00020ac8,201305,201495,1,1,190,3
0001efde,201255,201525,7,0,270,3
00039147,201015,201535,11,2,520,3
00029de5,201285,201595,10,1,310,3
00025445,201195,201635,15,1,440,3
00013e2f,201285,201665,9,0,380,3
0003ed68,201635,201705,2,2,70,3
00042f26,201545,201725,13,3,180,3
00040bdc,201465,201875,4,3,410,3
00029735,201645,201905,6,1,260,3
00038071,201385,201905,1,2,520,3
00017ce4,201805,201915,4,0,110,3
00019b23,201725,201975,3,0,250,3
00016cf7,201475,202015,11,0,540,3
00030634,201775,202055,14,2,280,3
00044587,201885,202065,10,3,180,3
00048649,201655,202125,9,3,470,3
0003bef2,201935,202395,7,2,460,3
0004914b,115,575,6,3,460,3
00031db6,100235,100335,12,2,100,3
0004e77e,100335,100475,14,3,140,3
0002564a,100235,100505,5,1,270,3
00048062,100355,100515,1,3,160,3
000405b2,100325,100615,2,3,290,3
00039208,100305,100665,9,2,360,3
0001ece5,100455,100715,8,0,260,3
0003054b,100615,100775,0,2,160,3
00018544,100395,100805,11,0,410,3
0002c608,100535,100845,9,1,310,3
000395d8,100555,100975,6,2,420,3
0002411a,100685,101055,10,1,370,3
00034271,100835,101145,10,2,310,3
0002332c,100785,101195,7,1,410,3
0001065f,100985,101215,12,0,230,3
0004b17c,100735,101235,6,3,500,3
00011e08,101055,101315,12,0,260,3
000382d1,100895,101405,6,2,510,3
000223f4,101135,101425,14,1,290,3
000171ac,101005,101435,11,0,430,3
0002ca20,101015,101465,7,1,450,3
00042fd6,100985,101475,7,3,490,3
00038b98,101075,101485,10,2,410,3
0003fa42,101595,101675,12,2,80,3
0004572b,101305,101705,0,3,400,3
0003b135,101305,101735,7,2,430,3
0003e497,101265,101795,11,2,530,3
0002298a,101525,101865,13,1,340,3
00043fc8,101265,101885,9,3,620,3
0004b3c5,101455,101925,4,3,470,3
0002f2db,101385,101965,11,1,580,3
0003b135,101305,101975,7,2,670,3
000326f4,200525,200565,2,2,40,3
000480c2,200475,200655,14,3,180,3
00019c5c,200355,200665,8,0,310,3
000387e7,200395,200695,5,2,300,3
00016fca,200615,200725,0,0,110,3
0002090f,200655,200855,5,1,200,3
00023d1c,200785,200895,4,1,110,3
00040281,200355,200915,6,3,560,3
0001440d,200695,201085,11,0,390,3
000493d8,201105,201175,12,3,70,3
00012004,200945,201185,5,0,240,3
000406d9,200875,201215,11,3,340,3
0002137b,201095,201355,5,1,260,3
0001d671,201165,201485,13,0,320,3
00020ac8,201305,201495,1,1,190,3
0001efde,201255,201525,7,0,270,3
00039147,201015,201535,11,2,520,3
00029de5,201285,201595,10,1,310,3
00025445,201195,201635,15,1,440,3
00013e2f,201285,201665,9,0,380,3
0003ed68,201635,201705,2,2,70,3
00042f26,201545,201725,13,3,180,3
00040bdc,201465,201875,4,3,410,3
00029735,201645,201905,6,1,260,3
00038071,201385,201905,1,2,520,3
00017ce4,201805,201915,4,0,110,3
00019b23,201725,201975,3,0,250,3
00016cf7,201475,202015,11,0,540,3
00030634,201775,202055,14,2,280,3
00044587,201885,202065,10,3,180,3
00048649,201655,202125,9,3,470,3
0003bef2,201935,202395,7,2,460,3
0001f16a,300425,300505,1,0,80,3
000245c0,300495,300595,1,1,100,3
0001c8af,300425,300615,6,0,190,3
0001c6eb,300595,300775,1,0,180,3
00049e1a,300655,300775,2,3,120,3
0003476e,300435,300805,9,2,370,3
0004c9a8,300655,300885,15,3,230,3
0004143f,300645,300925,1,3,280,3
000361ec,300515,300945,8,2,430,3
0001e3c6,300835,300995,2,0,160,3
0002ffa3,300725,301095,15,1,370,3
00011e0d,300775,301105,9,0,330,3
0002ffa3,300725,301195,15,1,470,3
00046076,301035,301195,13,3,160,3
00014075,300875,301335,9,0,460,3
0002581c,301045,301335,12,1,290,3
00037e8f,301345,301425,4,2,80,3
00014bd4,300945,301455,14,0,510,3
00046d57,301125,301505,6,3,380,3
00017578,301235,301535,12,0,300,3
00011b94,301515,301615,4,0,100,3
0002b385,301155,301635,6,1,480,3
0001a10b,301045,301675,15,0,630,3
00029942,301305,301745,14,1,440,3
00025a2b,301465,301785,6,1,320,3
00048530,301575,301805,13,3,230,3
0001ab29,301415,301955,14,0,540,3
0004914b,115,575,6,3,460,3
00031db6,100235,100335,12,2,100,3
0004e77e,100335,100475,14,3,140,3
0002564a,100235,100505,5,1,270,3
00048062,100355,100515,1,3,160,3
000405b2,100325,100615,2,3,290,3
00039208,100305,100665,9,2,360,3
0001ece5,100455,100715,8,0,260,3
0003054b,100615,100775,0,2,160,3
00018544,100395,100805,11,0,410,3
0002c608,100535,100845,9,1,310,3
000395d8,100555,100975,6,2,420,3
0002411a,100685,101055,10,1,370,3
00034271,100835,101145,10,2,310,3
0002332c,100785,101195,7,1,410,3
0001065f,100985,101215,12,0,230,3
0004b17c,100735,101235,6,3,500,3
00011e08,101055,101315,12,0,260,3
000382d1,100895,101405,6,2,510,3
000223f4,101135,101425,14,1,290,3
000171ac,101005,101435,11,0,430,3
0002ca20,101015,101465,7,1,450,3
00042fd6,100985,101475,7,3,490,3
00038b98,101075,101485,10,2,410,3
0003fa42,101595,101675,12,2,80,3
0004572b,101305,101705,0,3,400,3
0003b135,101305,101735,7,2,430,3
0003e497,101265,101795,11,2,530,3
0002298a,101525,101865,13,1,340,3
00043fc8,101265,101885,9,3,620,3
0004b3c5,101455,101925,4,3,470,3
0002f2db,101385,101965,11,1,580,3
0003b135,101305,101975,7,2,670,3
000326f4,200525,200565,2,2,40,3
000480c2,200475,200655,14,3,180,3
00019c5c,200355,200665,8,0,310,3
000387e7,200395,200695,5,2,300,3
00016fca,200615,200725,0,0,110,3
0002090f,200655,200855,5,1,200,3
00023d1c,200785,200895,4,1,110,3
00040281,200355,200915,6,3,560,3
0001440d,200695,201085,11,0,390,3
000493d8,201105,201175,12,3,70,3
00012004,200945,201185,5,0,240,3
000406d9,200875,201215,11,3,340,3
0002137b,201095,201355,5,1,260,3
0001d671,201165,201485,13,0,320,3
00020ac8,201305,201495,1,1,190,3
0001efde,201255,201525,7,0,270,3
00039147,201015,201535,11,2,520,3
00029de5,201285,201595,10,1,310,3
00025445,201195,201635,15,1,440,3
00013e2f,201285,201665,9,0,380,3
0003ed68,201635,201705,2,2,70,3
00042f26,201545,201725,13,3,180,3
00040bdc,201465,201875,4,3,410,3
00029735,201645,201905,6,1,260,3
00038071,201385,201905,1,2,520,3
00017ce4,201805,201915,4,0,110,3
00019b23,201725,201975,3,0,250,3
00016cf7,201475,202015,11,0,540,3
00030634,201775,202055,14,2,280,3
00044587,201885,202065,10,3,180,3
00048649,201655,202125,9,3,470,3
0003bef2,201935,202395,7,2,460,3
0001f16a,300425,300505,1,0,80,3
000245c0,300495,300595,1,1,100,3
0001c8af,300425,300615,6,0,190,3
0001c6eb,300595,300775,1,0,180,3
00049e1a,300655,300775,2,3,120,3
0003476e,300435,300805,9,2,370,3
0004c9a8,300655,300885,15,3,230,3
0004143f,300645,300925,1,3,280,3
000361ec,300515,300945,8,2,430,3
0001e3c6,300835,300995,2,0,160,3
0002ffa3,300725,301095,15,1,370,3
00011e0d,300775,301105,9,0,330,3
0002ffa3,300725,301195,15,1,470,3
00046076,301035,301195,13,3,160,3
00014075,300875,301335,9,0,460,3
0002581c,301045,301335,12,1,290,3
00037e8f,301345,301425,4,2,80,3
00014bd4,300945,301455,14,0,510,3
00046d57,301125,301505,6,3,380,3
00017578,301235,301535,12,0,300,3
00011b94,301515,301615,4,0,100,3
0002b385,301155,301635,6,1,480,3
0001a10b,301045,301675,15,0,630,3
00029942,301305,301745,14,1,440,3
00025a2b,301465,301785,6,1,320,3
00048530,301575,301805,13,3,230,3
0001ab29,301415,301955,14,0,540,3
0004bc1a,400615,400735,13,3,120,3
00038947,400555,400755,0,2,200,3
0003b797,400705,400865,12,2,160,3
0004bf8c,400545,400965,9,3,420,3
000124c2,400965,400995,0,0,30,3
0001d64d,400875,401035,1,0,160,3
0003e27d,400635,401095,9,2,460,3
0004e103,401125,401185,12,3,60,3
00047736,400995,401225,15,3,230,3
0004b0b7,400795,401265,5,3,470,3
00011227,401045,401275,2,0,230,3
0001e52d,401155,401375,1,0,220,3
00043789,401245,401385,2,3,140,3
00046a9d,401255,401665,6,3,410,3
0003f9e0,401335,401705,9,2,370,3
00029cc1,401565,401715,12,1,150,3
0001cc41,401485,401725,7,0,240,3
000307a9,401705,401805,3,2,100,3
00011fce,401615,401825,5,0,210,3
0003ce33,401425,401865,9,2,440,3
00038865,401705,401925,12,2,220,3
000405ee,401545,401945,9,3,400,3
000126a5,401895,401985,1,0,90,3
0003e917,401775,401985,1,2,210,3
00027f5a,401705,402025,8,1,320,3
0004dcaf,401805,402115,4,3,310,3
00015b7e,125,245,2,0,120,6
00015b7e,125,245,2,0,120,6
0001ac09,100275,100405,2,0,130,6
000418ea,100325,100555,0,3,230,6
0003ebe5,100385,100645,4,2,260,6
0001724e,100535,100795,3,0,260,6
00015dd8,100445,100835,11,0,390,6
0004f2e2,100625,100875,15,3,250,6
0001fad1,100645,100995,13,0,350,6
00010e47,100715,101235,11,0,520,6
00015b7e,125,245,2,0,120,6
0001ac09,100275,100405,2,0,130,6
000418ea,100325,100555,0,3,230,6
0003ebe5,100385,100645,4,2,260,6
0001724e,100535,100795,3,0,260,6
00015dd8,100445,100835,11,0,390,6
0004f2e2,100625,100875,15,3,250,6
0001fad1,100645,100995,13,0,350,6
00010e47,100715,101235,11,0,520,6
00032d44,200445,200565,1,2,120,6
0002403c,200435,200595,4,1,160,6
0002ad71,200525,200675,3,1,150,6
000215b7,200365,200715,11,1,350,6
0002b1dc,200525,200785,8,1,260,6
00012bdb,200675,200795,4,0,120,6
00045f6d,200645,200805,14,3,160,6
00012ac2,200765,200845,5,0,80,6
000311ce,200565,200955,8,2,390,6
00049f6d,200535,201025,9,3,490,6
00013628,201025,201095,0,0,70,6
00026b6c,200785,201095,9,1,310,6
0004c48d,200925,201185,14,3,260,6
00024bed,200865,201235,10,1,370,6
00024dbe,201115,201275,4,1,160,6
0004bfd2,201005,201275,1,3,270,6
00012635,201135,201445,13,0,310,6
000320aa,201335,201475,1,2,140,6
00038290,201325,201565,15,2,240,6
000422e1,201475,201595,12,3,120,6
00036e8b,201245,201605,8,2,360,6
00042931,201205,201635,5,3,430,6
00014212,201535,201695,5,0,160,6
0002583a,201395,201725,7,1,330,6
0002a137,201685,201785,1,1,100,6
0002a99c,201445,201875,11,1,430,6
00015b7e,125,245,2,0,120,6
0001ac09,100275,100405,2,0,130,6
000418ea,100325,100555,0,3,230,6
0003ebe5,100385,100645,4,2,260,6
0001724e,100535,100795,3,0,260,6
00015dd8,100445,100835,11,0,390,6
0004f2e2,100625,100875,15,3,250,6
0001fad1,100645,100995,13,0,350,6
00010e47,100715,101235,11,0,520,6
00032d44,200445,200565,1,2,120,6
0002403c,200435,200595,4,1,160,6
0002ad71,200525,200675,3,1,150,6
000215b7,200365,200715,11,1,350,6
0002b1dc,200525,200785,8,1,260,6
00012bdb,200675,200795,4,0,120,6
00045f6d,200645,200805,14,3,160,6
00012ac2,200765,200845,5,0,80,6
000311ce,200565,200955,8,2,390,6
00049f6d,200535,201025,9,3,490,6
00013628,201025,201095,0,0,70,6
00026b6c,200785,201095,9,1,310,6
0004c48d,200925,201185,14,3,260,6
00024bed,200865,201235,10,1,370,6
00024dbe,201115,201275,4,1,160,6
0004bfd2,201005,201275,1,3,270,6
00012635,201135,201445,13,0,310,6
000320aa,201335,201475,1,2,140,6
00038290,201325,201565,15,2,240,6
000422e1,201475,201595,12,3,120,6
00036e8b,201245,201605,8,2,360,6
00042931,201205,201635,5,3,430,6
00014212,201535,201695,5,0,160,6
0002583a,201395,201725,7,1,330,6
0002a137,201685,201785,1,1,100,6
0002a99c,201445,201875,11,1,430,6
0004a9d1,201625,201975,15,3,350,6
0004ad8b,201565,202015,9,3,450,6
0001b257,201765,202305,14,0,540,6
0003c6a3,300425,300525,12,2,100,6
000253dc,300625,300735,12,1,110,6
0004eac0,300565,300745,2,3,180,6
0003427b,300515,300755,4,2,240,6
000252b1,300475,300775,6,1,300,6
0002f774,300665,300815,0,1,150,6
0004612a,300535,300865,11,3,330,6
0001f743,300525,300895,14,0,370,6
00047421,300475,301005,8,3,530,6
00032cfd,300685,301015,12,2,330,6
000207ae,300755,301065,6,1,310,6
0001079e,300585,301095,3,0,510,6
00015b7e,125,245,2,0,120,6
0001ac09,100275,100405,2,0,130,6
000418ea,100325,100555,0,3,230,6
0003ebe5,100385,100645,4,2,260,6
0001724e,100535,100795,3,0,260,6
00015dd8,100445,100835,11,0,390,6
0004f2e2,100625,100875,15,3,250,6
0001fad1,100645,100995,13,0,350,6
00010e47,100715,101235,11,0,520,6
00032d44,200445,200565,1,2,120,6
0002403c,200435,200595,4,1,160,6
0002ad71,200525,200675,3,1,150,6
000215b7,200365,200715,11,1,350,6
0002b1dc,200525,200785,8,1,260,6
00012bdb,200675,200795,4,0,120,6
00045f6d,200645,200805,14,3,160,6
00012ac2,200765,200845,5,0,80,6
000311ce,200565,200955,8,2,390,6
00049f6d,200535,201025,9,3,490,6
00013628,201025,201095,0,0,70,6
00026b6c,200785,201095,9,1,310,6
0004c48d,200925,201185,14,3,260,6
00024bed,200865,201235,10,1,370,6
00024dbe,201115,201275,4,1,160,6
0004bfd2,201005,201275,1,3,270,6
00012635,201135,201445,13,0,310,6
000320aa,201335,201475,1,2,140,6
00038290,201325,201565,15,2,240,6
000422e1,201475,201595,12,3,120,6
00036e8b,201245,201605,8,2,360,6
00042931,201205,201635,5,3,430,6
00014212,201535,201695,5,0,160,6
0002583a,201395,201725,7,1,330,6
0002a137,201685,201785,1,1,100,6
0002a99c,201445,201875,11,1,430,6
0004a9d1,201625,201975,15,3,350,6
0004ad8b,201565,202015,9,3,450,6
0001b257,201765,202305,14,0,540,6
0003c6a3,300425,300525,12,2,100,6
000253dc,300625,300735,12,1,110,6
0004eac0,300565,300745,2,3,180,6
0003427b,300515,300755,4,2,240,6
000252b1,300475,300775,6,1,300,6
0002f774,300665,300815,0,1,150,6
0004612a,300535,300865,11,3,330,6
0001f743,300525,300895,14,0,370,6
00047421,300475,301005,8,3,530,6
00032cfd,300685,301015,12,2,330,6
000207ae,300755,301065,6,1,310,6
0001079e,300585,301095,3,0,510,6
0001587b,400715,400835,2,0,120,6
0003201c,400545,400845,5,2,300,6
000236a9,400625,400865,9,1,240,6
0002191f,400765,400985,5,1,220,6
00035e6c,400985,401145,12,2,160,6
00018370,400855,401205,13,0,350,6
00018b65,400895,401365,10,0,470,6
0003f687,401055,401415,10,2,360,6
00048b3b,400945,401475,9,3,530,6
0001a8b7,401175,401505,6,0,330,6
0003d199,401275,401555,4,2,280,6
0001c1ce,401145,401585,13,0,440,6
0001a8b7,401175,401625,6,0,450,6
00048fa9,401365,401655,13,3,290,6
00039b6b,401285,401675,5,2,390,6
0002ccf9,401285,401705,13,1,420,6
000123d1,401175,401725,8,0,550,6
000160bd,401205,401825,8,0,620,6
0004ba35,185,525,10,3,340,4
0004ba35,185,525,10,3,340,4
0004e1b0,100325,100445,2,3,120,4
0003ba79,100395,100485,2,2,90,4
0004b15a,100255,100545,0,3,290,4
0002caea,100405,100635,5,1,230,4
00025584,100545,100695,12,1,150,4
00010da4,100475,100805,14,0,330,4
00029e85,100515,100815,9,1,300,4
0003dc29,100715,100825,13,2,110,4
0003f5d4,100665,100885,1,2,220,4
00044741,100465,100895,9,3,430,4
0004a40f,100845,101015,1,3,170,4
0003fffd,100985,101025,2,2,40,4
0003d110,100735,101105,6,2,370,4
0004e54d,100895,101105,14,3,210,4
00020cca,101025,101155,4,1,130,4
0001883c,100785,101185,10,0,400,4
000457f0,100595,101205,8,3,610,4
0004e0c7,101015,101245,2,3,230,4
0004ba35,185,525,10,3,340,4
0004e1b0,100325,100445,2,3,120,4
0003ba79,100395,100485,2,2,90,4
0004b15a,100255,100545,0,3,290,4
0002caea,100405,100635,5,1,230,4
00025584,100545,100695,12,1,150,4
00010da4,100475,100805,14,0,330,4
00029e85,100515,100815,9,1,300,4
0003dc29,100715,100825,13,2,110,4
0003f5d4,100665,100885,1,2,220,4
00044741,100465,100895,9,3,430,4
0004a40f,100845,101015,1,3,170,4
0003fffd,100985,101025,2,2,40,4
0003d110,100735,101105,6,2,370,4
0004e54d,100895,101105,14,3,210,4
00020cca,101025,101155,4,1,130,4
0001883c,100785,101185,10,0,400,4
000457f0,100595,101205,8,3,610,4
0004e0c7,101015,101245,2,3,230,4
00026386,200325,200445,3,1,120,4
00048457,200405,200555,2,3,150,4
000222bf,200435,200705,14,1,270,4
0003618d,200425,200725,10,2,300,4
00043f5e,200495,200735,0,3,240,4
0004d0a6,200585,200815,11,3,230,4
00032d89,200735,200835,1,2,100,4
0004ee8d,200785,200875,3,3,90,4
00020810,200665,200965,10,1,300,4
0003aae2,200815,200995,13,2,180,4
00018bbc,200935,201035,0,0,100,4
0004bd93,200795,201095,11,3,300,4
0003c01e,200855,201225,9,2,370,4
0004ba35,185,525,10,3,340,4
0004e1b0,100325,100445,2,3,120,4
0003ba79,100395,100485,2,2,90,4
0004b15a,100255,100545,0,3,290,4
0002caea,100405,100635,5,1,230,4
00025584,100545,100695,12,1,150,4
00010da4,100475,100805,14,0,330,4
00029e85,100515,100815,9,1,300,4
0003dc29,100715,100825,13,2,110,4
0003f5d4,100665,100885,1,2,220,4
00044741,100465,100895,9,3,430,4
0004a40f,100845,101015,1,3,170,4
0003fffd,100985,101025,2,2,40,4
0003d110,100735,101105,6,2,370,4
0004e54d,100895,101105,14,3,210,4
00020cca,101025,101155,4,1,130,4
0001883c,100785,101185,10,0,400,4
000457f0,100595,101205,8,3,610,4
0004e0c7,101015,101245,2,3,230,4
00026386,200325,200445,3,1,120,4
00048457,200405,200555,2,3,150,4
000222bf,200435,200705,14,1,270,4
0003618d,200425,200725,10,2,300,4
00043f5e,200495,200735,0,3,240,4
0004d0a6,200585,200815,11,3,230,4
00032d89,200735,200835,1,2,100,4
0004ee8d,200785,200875,3,3,90,4
00020810,200665,200965,10,1,300,4
0003aae2,200815,200995,13,2,180,4
00018bbc,200935,201035,0,0,100,4
0004bd93,200795,201095,11,3,300,4
0003c01e,200855,201225,9,2,370,4
00037004,300475,300515,2,2,40,4
0003e05f,300525,300605,12,2,80,4
000462ad,300475,300695,11,3,220,4
0003617c,300685,300775,1,2,90,4
00044445,300765,300855,12,3,90,4
00045dc0,300515,300965,9,3,450,4
00036163,300595,300975,11,2,380,4
0004ba35,185,525,10,3,340,4
0004e1b0,100325,100445,2,3,120,4
0003ba79,100395,100485,2,2,90,4
0004b15a,100255,100545,0,3,290,4
0002caea,100405,100635,5,1,230,4
00025584,100545,100695,12,1,150,4
00010da4,100475,100805,14,0,330,4
00029e85,100515,100815,9,1,300,4
0003dc29,100715,100825,13,2,110,4
0003f5d4,100665,100885,1,2,220,4
00044741,100465,100895,9,3,430,4
0004a40f,100845,101015,1,3,170,4
0003fffd,100985,101025,2,2,40,4
0003d110,100735,101105,6,2,370,4
0004e54d,100895,101105,14,3,210,4
00020cca,101025,101155,4,1,130,4
0001883c,100785,101185,10,0,400,4
000457f0,100595,101205,8,3,610,4
0004e0c7,101015,101245,2,3,230,4
00026386,200325,200445,3,1,120,4
00048457,200405,200555,2,3,150,4
000222bf,200435,200705,14,1,270,4
0003618d,200425,200725,10,2,300,4
00043f5e,200495,200735,0,3,240,4
0004d0a6,200585,200815,11,3,230,4
00032d89,200735,200835,1,2,100,4
0004ee8d,200785,200875,3,3,90,4
00020810,200665,200965,10,1,300,4
0003aae2,200815,200995,13,2,180,4
00018bbc,200935,201035,0,0,100,4
0004bd93,200795,201095,11,3,300,4
0003c01e,200855,201225,9,2,370,4
00037004,300475,300515,2,2,40,4
0003e05f,300525,300605,12,2,80,4
000462ad,300475,300695,11,3,220,4
0003617c,300685,300775,1,2,90,4
00044445,300765,300855,12,3,90,4
00045dc0,300515,300965,9,3,450,4
00036163,300595,300975,11,2,380,4
0004d85b,300625,301045,9,3,420,4
00048729,300625,301225,9,3,600,4
0001cc05,400605,400685,1,0,80,4
0003e500,400755,400855,12,2,100,4
00017e6b,400835,400885,4,0,50,4
0002ae83,400825,400895,1,1,70,4
00033ce6,400815,400975,12,2,160,4
00048828,400575,400985,9,3,410,4
0004d6db,400905,401065,12,3,160,4
0003bda5,400665,401095,11,2,430,4
0004f100,400535,401125,7,3,590,4
0001951e,401105,401155,0,0,50,4
000271b6,401015,401155,4,1,140,4
000266f4,400845,401215,14,1,370,4
0002d32d,400945,401315,3,1,370,4
00044d1c,401175,401415,1,3,240,4
00016f14,401065,401425,9,0,360,4
00016ffd,401485,401625,2,0,140,4
0002fdca,401245,401655,15,1,410,4
0004e076,401335,401655,15,3,320,4
00020067,401425,401695,9,1,270,4
00042e89,401425,401695,1,3,270,4
0003ab23,401565,401785,3,2,220,4
00034ed6,401705,401875,0,2,170,4
0003eba6,401795,401975,1,2,180,4
000205ff,401645,402005,10,1,360,4
0003b8d1,401775,402075,4,2,300,4
0001bd70,401795,402085,8,0,290,4
00039154,402045,402135,12,2,90,4
000115b6,401985,402185,1,0,200,4
00011f08,401905,402225,9,0,320,4
0004a3af,401825,402235,5,3,410,4
0003ced1,402095,402295,0,2,200,4
00014700,115,275,5,0,160,8
00014700,115,275,5,0,160,8
0001767c,100255,100355,4,0,100,8
0002d3d1,100395,100435,1,1,40,8
00037e02,100196,100495,9,2,299,8
0002d929,100395,100535,1,1,140,8
0004994e,100495,100595,2,3,100,8
0001e65e,100395,100655,12,0,260,8
0003abd5,100565,100695,3,2,130,8
00012219,100455,100705,7,0,250,8
00037232,100325,100735,6,2,410,8
0004bc6b,100625,100735,3,3,110,8
0002d660,100585,100745,2,1,160,8
0001625d,100725,100775,4,0,50,8
0001fcd5,100775,100885,4,0,110,8
0003d094,100705,101015,9,2,310,8
0001f5d7,100725,101085,14,0,360,8
000413cc,100555,101085,6,3,530,8
00012e32,100935,101155,6,0,220,8
0002634d,100885,101185,13,1,300,8
0001ccd7,100855,101235,12,0,380,8
00027521,100885,101265,12,1,380,8
0003c46a,100855,101275,11,2,420,8
0004dea9,100945,101385,9,3,440,8
00014700,115,275,5,0,160,8
0001767c,100255,100355,4,0,100,8
0002d3d1,100395,100435,1,1,40,8
00037e02,100196,100495,9,2,299,8
0002d929,100395,100535,1,1,140,8
0004994e,100495,100595,2,3,100,8
0001e65e,100395,100655,12,0,260,8
0003abd5,100565,100695,3,2,130,8
00012219,100455,100705,7,0,250,8
00037232,100325,100735,6,2,410,8
0004bc6b,100625,100735,3,3,110,8
0002d660,100585,100745,2,1,160,8
0001625d,100725,100775,4,0,50,8
0001fcd5,100775,100885,4,0,110,8
0003d094,100705,101015,9,2,310,8
0001f5d7,100725,101085,14,0,360,8
000413cc,100555,101085,6,3,530,8
00012e32,100935,101155,6,0,220,8
0002634d,100885,101185,13,1,300,8
0001ccd7,100855,101235,12,0,380,8
00027521,100885,101265,12,1,380,8
0003c46a,100855,101275,11,2,420,8
0004dea9,100945,101385,9,3,440,8
000362e3,200445,200645,0,2,200,8
0004d6ae,200385,200685,10,3,300,8
00014700,115,275,5,0,160,8
0001767c,100255,100355,4,0,100,8
0002d3d1,100395,100435,1,1,40,8
00037e02,100196,100495,9,2,299,8
0002d929,100395,100535,1,1,140,8
0004994e,100495,100595,2,3,100,8
0001e65e,100395,100655,12,0,260,8
0003abd5,100565,100695,3,2,130,8
00012219,100455,100705,7,0,250,8
00037232,100325,100735,6,2,410,8
0004bc6b,100625,100735,3,3,110,8
0002d660,100585,100745,2,1,160,8
0001625d,100725,100775,4,0,50,8
0001fcd5,100775,100885,4,0,110,8
0003d094,100705,101015,9,2,310,8
0001f5d7,100725,101085,14,0,360,8
000413cc,100555,101085,6,3,530,8
00012e32,100935,101155,6,0,220,8
0002634d,100885,101185,13,1,300,8
0001ccd7,100855,101235,12,0,380,8
00027521,100885,101265,12,1,380,8
0003c46a,100855,101275,11,2,420,8
0004dea9,100945,101385,9,3,440,8
000362e3,200445,200645,0,2,200,8
0004d6ae,200385,200685,10,3,300,8
00012f1d,300415,300495,1,0,80,8
00047cc3,300475,300535,12,3,60,8
00011aed,300555,300625,4,0,70,8
0002ae9f,300505,300745,9,1,240,8
00044734,300615,300755,14,3,140,8
00011078,300525,300895,15,0,370,8
00043650,300585,300965,15,3,380,8
0003c444,300755,301085,5,2,330,8
0002683c,155,355,13,1,200,4
0002683c,155,355,13,1,200,4
00046f00,100325,100445,13,3,120,4
00049136,100375,100525,13,3,150,4
000366eb,100235,100555,5,2,320,4
00045274,100435,100585,3,3,150,4
00043e5d,100375,100685,0,3,310,4
0002ce84,100535,100705,12,1,170,4
0004469e,100605,100765,13,3,160,4
0003559c,100445,100795,9,2,350,4
0004f383,100375,100805,9,3,430,4
00042b50,100375,100885,5,3,510,4
0004c092,100245,100925,8,3,680,4
00032cbf,100755,100935,0,2,180,4
0004655f,100895,100965,3,3,70,4
00041e52,100855,101025,13,3,170,4
00013877,100905,101065,2,0,160,4
00020385,100695,101085,9,1,390,4
0004c15d,100445,101165,9,3,720,4
0003968c,100775,101175,11,2,400,4
000276a8,100745,101185,9,1,440,4
00044170,100965,101245,14,3,280,4
00030620,101055,101265,6,2,210,4
00023bcd,101055,101335,13,1,280,4
0004bba3,101005,101355,11,3,350,4
0004e84e,101055,101495,7,3,440,4
0003f4b5,101145,101505,14,2,360,4
00032a15,101175,101545,15,2,370,4
0004d2e6,101305,101615,0,3,310,4
0002b1ae,101095,101695,15,1,600,4
00039c8b,101265,101785,15,2,520,4
0002683c,155,355,13,1,200,4
00046f00,100325,100445,13,3,120,4
00049136,100375,100525,13,3,150,4
000366eb,100235,100555,5,2,320,4
00045274,100435,100585,3,3,150,4
00043e5d,100375,100685,0,3,310,4
0002ce84,100535,100705,12,1,170,4
0004469e,100605,100765,13,3,160,4
0003559c,100445,100795,9,2,350,4
0004f383,100375,100805,9,3,430,4
00042b50,100375,100885,5,3,510,4
0004c092,100245,100925,8,3,680,4
00032cbf,100755,100935,0,2,180,4
0004655f,100895,100965,3,3,70,4
00041e52,100855,101025,13,3,170,4
00013877,100905,101065,2,0,160,4
00020385,100695,101085,9,1,390,4
0004c15d,100445,101165,9,3,720,4
0003968c,100775,101175,11,2,400,4
000276a8,100745,101185,9,1,440,4
00044170,100965,101245,14,3,280,4
00030620,101055,101265,6,2,210,4
00023bcd,101055,101335,13,1,280,4
0004bba3,101005,101355,11,3,350,4
0004e84e,101055,101495,7,3,440,4
0003f4b5,101145,101505,14,2,360,4
00032a15,101175,101545,15,2,370,4
0004d2e6,101305,101615,0,3,310,4
0002b1ae,101095,101695,15,1,600,4
00039c8b,101265,101785,15,2,520,4
000174e8,200535,200645,4,0,110,4
00040ee2,200595,200675,3,3,80,4
00029e48,200395,200685,6,1,290,4
00019550,200385,200705,7,0,320,4
000189d5,200535,200765,12,0,230,4
0001a5b2,200425,200805,7,0,380,4
0002b42d,200625,200825,13,1,200,4
0002b433,200565,200865,4,1,300,4
0004dd70,200505,200895,9,3,390,4
00012ee6,200565,200905,7,0,340,4
0002477a,200725,200905,1,1,180,4
0002683c,155,355,13,1,200,4
00046f00,100325,100445,13,3,120,4
00049136,100375,100525,13,3,150,4
000366eb,100235,100555,5,2,320,4
00045274,100435,100585,3,3,150,4
00043e5d,100375,100685,0,3,310,4
0002ce84,100535,100705,12,1,170,4
0004469e,100605,100765,13,3,160,4
0003559c,100445,100795,9,2,350,4
0004f383,100375,100805,9,3,430,4
00042b50,100375,100885,5,3,510,4
0004c092,100245,100925,8,3,680,4
00032cbf,100755,100935,0,2,180,4
0004655f,100895,100965,3,3,70,4
00041e52,100855,101025,13,3,170,4
00013877,100905,101065,2,0,160,4
00020385,100695,101085,9,1,390,4
0004c15d,100445,101165,9,3,720,4
0003968c,100775,101175,11,2,400,4
000276a8,100745,101185,9,1,440,4
00044170,100965,101245,14,3,280,4
00030620,101055,101265,6,2,210,4
00023bcd,101055,101335,13,1,280,4
0004bba3,101005,101355,11,3,350,4
0004e84e,101055,101495,7,3,440,4
0003f4b5,101145,101505,14,2,360,4
00032a15,101175,101545,15,2,370,4
0004d2e6,101305,101615,0,3,310,4
0002b1ae,101095,101695,15,1,600,4
00039c8b,101265,101785,15,2,520,4
000174e8,200535,200645,4,0,110,4
00040ee2,200595,200675,3,3,80,4
00029e48,200395,200685,6,1,290,4
00019550,200385,200705,7,0,320,4
000189d5,200535,200765,12,0,230,4
0001a5b2,200425,200805,7,0,380,4
0002b42d,200625,200825,13,1,200,4
0002b433,200565,200865,4,1,300,4
0004dd70,200505,200895,9,3,390,4
00012ee6,200565,200905,7,0,340,4
0002477a,200725,200905,1,1,180,4
000396d6,200595,201025,4,2,430,4
00022f78,200635,201035,15,1,400,4
0001a896,200505,201155,15,0,650,4
0002c4e0,200595,201175,4,1,580,4
000412f8,300555,300595,3,3,40,4
00015edb,300645,300685,0,0,40,4
000165e6,300465,300795,14,0,330,4
00022568,300685,300895,9,1,210,4
00024580,300765,300935,4,1,170,4
0002a647,300845,300975,1,1,130,4
000281f7,300665,301055,7,1,390,4
00040af6,300645,301065,8,3,420,4
00027daa,300815,301135,9,1,320,4
0004899b,300905,301275,15,3,370,4
0004d50a,300975,301315,4,3,340,4
0004f9c1,301325,301385,12,3,60,4
00017cf2,301045,301395,14,0,350,4
0002a2ba,301275,301405,0,1,130,4
00046844,301115,301425,11,3,310,4
00017e90,301095,301565,7,0,470,4
00035430,301315,301585,15,2,270,4
0002ef3c,301465,301595,0,1,130,4
0002932b,301375,301775,13,1,400,4
00034fd0,301635,301865,10,2,230,4
0003cb75,301555,301905,0,2,350,4
00029323,301565,301935,9,1,370,4
00019f0e,301235,301965,15,0,730,4
0003538f,301625,302005,6,2,380,4
0003f793,301175,302045,7,2,870,4
00026dbd,301555,302055,14,1,500,4
0001ae0d,301595,302105,11,0,510,4
0002683c,155,355,13,1,200,4
00046f00,100325,100445,13,3,120,4
00049136,100375,100525,13,3,150,4
000366eb,100235,100555,5,2,320,4
00045274,100435,100585,3,3,150,4
00043e5d,100375,100685,0,3,310,4
0002ce84,100535,100705,12,1,170,4
0004469e,100605,100765,13,3,160,4
0003559c,100445,100795,9,2,350,4
0004f383,100375,100805,9,3,430,4
00042b50,100375,100885,5,3,510,4
0004c092,100245,100925,8,3,680,4
00032cbf,100755,100935,0,2,180,4
0004655f,100895,100965,3,3,70,4
00041e52,100855,101025,13,3,170,4
00013877,100905,101065,2,0,160,4
00020385,100695,101085,9,1,390,4
0004c15d,100445,101165,9,3,720,4
0003968c,100775,101175,11,2,400,4
000276a8,100745,101185,9,1,440,4
00044170,100965,101245,14,3,280,4
00030620,101055,101265,6,2,210,4
00023bcd,101055,101335,13,1,280,4
0004bba3,101005,101355,11,3,350,4
0004e84e,101055,101495,7,3,440,4
0003f4b5,101145,101505,14,2,360,4
00032a15,101175,101545,15,2,370,4
0004d2e6,101305,101615,0,3,310,4
0002b1ae,101095,101695,15,1,600,4
00039c8b,101265,101785,15,2,520,4
000174e8,200535,200645,4,0,110,4
00040ee2,200595,200675,3,3,80,4
00029e48,200395,200685,6,1,290,4
00019550,200385,200705,7,0,320,4
000189d5,200535,200765,12,0,230,4
0001a5b2,200425,200805,7,0,380,4
0002b42d,200625,200825,13,1,200,4
0002b433,200565,200865,4,1,300,4
0004dd70,200505,200895,9,3,390,4
00012ee6,200565,200905,7,0,340,4
0002477a,200725,200905,1,1,180,4
000396d6,200595,201025,4,2,430,4
00022f78,200635,201035,15,1,400,4
0001a896,200505,201155,15,0,650,4
0002c4e0,200595,201175,4,1,580,4
000412f8,300555,300595,3,3,40,4
00015edb,300645,300685,0,0,40,4
000165e6,300465,300795,14,0,330,4
00022568,300685,300895,9,1,210,4
00024580,300765,300935,4,1,170,4
0002a647,300845,300975,1,1,130,4
000281f7,300665,301055,7,1,390,4
00040af6,300645,301065,8,3,420,4
00027daa,300815,301135,9,1,320,4
0004899b,300905,301275,15,3,370,4
0004d50a,300975,301315,4,3,340,4
0004f9c1,301325,301385,12,3,60,4
00017cf2,301045,301395,14,0,350,4
0002a2ba,301275,301405,0,1,130,4
00046844,301115,301425,11,3,310,4
00017e90,301095,301565,7,0,470,4
00035430,301315,301585,15,2,270,4
0002ef3c,301465,301595,0,1,130,4
0002932b,301375,301775,13,1,400,4
00034fd0,301635,301865,10,2,230,4
0003cb75,301555,301905,0,2,350,4
00029323,301565,301935,9,1,370,4
00019f0e,301235,301965,15,0,730,4
0003538f,301625,302005,6,2,380,4
0003f793,301175,302045,7,2,870,4
00026dbd,301555,302055,14,1,500,4
0001ae0d,301595,302105,11,0,510,4
00017831,400595,400815,6,0,220,4
0003df34,400585,400925,9,2,340,4
0001e10b,400685,400935,5,0,250,4
00013c16,400535,401035,15,0,500,4
0004cd34,400815,401105,0,3,290,4
0001b707,400755,401135,8,0,380,4
0002c553,400885,401165,9,1,280,4
000408e3,400705,401185,5,3,480,4
00037d73,401005,401295,6,2,290,4
00010034,400915,401305,8,0,390,4
000447ec,401115,401385,1,3,270,4
000208ee,401245,401485,5,1,240,4
0004a138,401265,401565,0,3,300,4
0002fa38,401085,401585,11,1,500,4
0003a691,401195,401615,5,2,420,4
00015fa5,401265,401645,5,0,380,4
000471e4,401275,401645,11,3,370,4
000342d6,401375,401695,14,2,320,4
00023737,401425,401725,10,1,300,4
000363e5,401445,401735,0,2,290,4
00040891,401535,401805,14,3,270,4
00033968,401695,401835,5,2,140,4
000283a6,401525,401865,7,1,340,4
0003e356,401285,401875,6,2,590,4
00019c9c,401605,401895,6,0,290,4
00021c34,401525,402045,11,1,520,4
00042fae,401735,402085,0,3,350,4
0002da74,401755,402185,8,1,430,4
0001040b,401795,402195,6,0,400,4
000412f8,300555,402265,3,3,101710,4
00037021,115,375,10,2,260,5
00037021,115,375,10,2,260,5
0002ccfb,100255,100495,5,1,240,5
0002676e,100425,100675,13,1,250,5
00037417,100425,100675,4,2,250,5
0002ad17,100665,100725,0,1,60,5
00032b1f,100345,100765,7,2,420,5
00028161,100485,100845,8,1,360,5
00040e29,100685,100845,13,3,160,5
00039f2c,100575,100955,10,2,380,5
0001c145,100745,101085,9,0,340,5
0002caf0,100935,101095,3,1,160,5
00044de3,101075,101145,12,3,70,5
0003e975,100915,101205,5,2,290,5
0002cba3,100765,101235,11,1,470,5
0003d7cb,100985,101265,14,2,280,5
00023a86,100975,101275,9,1,300,5
00034362,100765,101305,7,2,540,5
0004a4ee,100855,101305,0,3,450,5
0003d7cb,100985,101405,14,2,420,5
000261f8,101055,101415,9,1,360,5
00040b78,101155,101425,1,3,270,5
0002db04,101075,101455,7,1,380,5
0003fda2,101365,101485,2,2,120,5
00021cb1,101075,101535,14,1,460,5
000302a1,101345,101565,10,2,220,5
000315e3,101455,101605,4,2,150,5
000101a8,101075,101625,15,0,550,5
00021626,101285,101635,3,1,350,5
000236ac,101245,101675,8,1,430,5
000148d1,101515,101755,6,0,240,5
00032fd7,101515,101925,15,2,410,5
00037021,115,375,10,2,260,5
0002ccfb,100255,100495,5,1,240,5
0002676e,100425,100675,13,1,250,5
00037417,100425,100675,4,2,250,5
0002ad17,100665,100725,0,1,60,5
00032b1f,100345,100765,7,2,420,5
00028161,100485,100845,8,1,360,5
00040e29,100685,100845,13,3,160,5
00039f2c,100575,100955,10,2,380,5
0001c145,100745,101085,9,0,340,5
0002caf0,100935,101095,3,1,160,5
00044de3,101075,101145,12,3,70,5
0003e975,100915,101205,5,2,290,5
0002cba3,100765,101235,11,1,470,5
0003d7cb,100985,101265,14,2,280,5
00023a86,100975,101275,9,1,300,5
00034362,100765,101305,7,2,540,5
0004a4ee,100855,101305,0,3,450,5
0003d7cb,100985,101405,14,2,420,5
000261f8,101055,101415,9,1,360,5
00040b78,101155,101425,1,3,270,5
0002db04,101075,101455,7,1,380,5
0003fda2,101365,101485,2,2,120,5
00021cb1,101075,101535,14,1,460,5
000302a1,101345,101565,10,2,220,5
000315e3,101455,101605,4,2,150,5
000101a8,101075,101625,15,0,550,5
00021626,101285,101635,3,1,350,5
000236ac,101245,101675,8,1,430,5
000148d1,101515,101755,6,0,240,5
00032fd7,101515,101925,15,2,410,5
0001dd8c,200355,200515,5,0,160,5
0004b1b6,200335,200515,14,3,180,5
00044cc1,200475,200595,12,3,120,5
0002876f,200645,200725,2,1,80,5
00025e65,200395,200765,7,1,370,5
00027a02,200585,200825,13,1,240,5
0003c574,200735,200835,2,2,100,5
0004f7a4,200515,200935,8,3,420,5
0001d6cd,200585,200995,14,0,410,5
0002e676,200675,201055,11,1,380,5
00017093,200695,201155,13,0,460,5
00037021,115,375,10,2,260,5
0002ccfb,100255,100495,5,1,240,5
0002676e,100425,100675,13,1,250,5
00037417,100425,100675,4,2,250,5
0002ad17,100665,100725,0,1,60,5
00032b1f,100345,100765,7,2,420,5
00028161,100485,100845,8,1,360,5
00040e29,100685,100845,13,3,160,5
00039f2c,100575,100955,10,2,380,5
0001c145,100745,101085,9,0,340,5
0002caf0,100935,101095,3,1,160,5
00044de3,101075,101145,12,3,70,5
0003e975,100915,101205,5,2,290,5
0002cba3,100765,101235,11,1,470,5
0003d7cb,100985,101265,14,2,280,5
00023a86,100975,101275,9,1,300,5
00034362,100765,101305,7,2,540,5
0004a4ee,100855,101305,0,3,450,5
0003d7cb,100985,101405,14,2,420,5
000261f8,101055,101415,9,1,360,5
00040b78,101155,101425,1,3,270,5
0002db04,101075,101455,7,1,380,5
0003fda2,101365,101485,2,2,120,5
00021cb1,101075,101535,14,1,460,5
000302a1,101345,101565,10,2,220,5
000315e3,101455,101605,4,2,150,5
000101a8,101075,101625,15,0,550,5
00021626,101285,101635,3,1,350,5
000236ac,101245,101675,8,1,430,5
000148d1,101515,101755,6,0,240,5
00032fd7,101515,101925,15,2,410,5
0001dd8c,200355,200515,5,0,160,5
0004b1b6,200335,200515,14,3,180,5
00044cc1,200475,200595,12,3,120,5
0002876f,200645,200725,2,1,80,5
00025e65,200395,200765,7,1,370,5
00027a02,200585,200825,13,1,240,5
0003c574,200735,200835,2,2,100,5
0004f7a4,200515,200935,8,3,420,5
0001d6cd,200585,200995,14,0,410,5
0002e676,200675,201055,11,1,380,5
00017093,200695,201155,13,0,460,5
00037173,300445,300565,1,2,120,5
00024126,300515,300625,2,1,110,5
0004b89c,300445,300765,10,3,320,5
00037987,300595,300815,13,2,220,5
00020e5a,300685,300835,4,1,150,5
00030b36,300435,300915,15,2,480,5
00019223,300855,300925,0,0,70,5
0002a4b2,300735,300975,4,1,240,5
0004ac74,300935,301025,3,3,90,5
00023ec9,300875,301065,12,1,190,5
0003dbfb,300975,301095,2,2,120,5
00028023,301075,301165,1,1,90,5
0003f6b1,300785,301175,8,2,390,5
000306bb,300845,301255,6,2,410,5
0001fdb3,300985,301295,12,0,310,5
00042a42,300995,301335,4,3,340,5
0004c123,300955,301545,5,3,590,5
00039dae,301215,301555,0,2,340,5
000304e5,301135,301635,8,2,500,5
0002ad89,301195,301665,7,1,470,5
0003cbed,301135,301675,6,2,540,5
00037021,115,375,10,2,260,5
0002ccfb,100255,100495,5,1,240,5
0002676e,100425,100675,13,1,250,5
00037417,100425,100675,4,2,250,5
0002ad17,100665,100725,0,1,60,5
00032b1f,100345,100765,7,2,420,5
00028161,100485,100845,8,1,360,5
00040e29,100685,100845,13,3,160,5
00039f2c,100575,100955,10,2,380,5
0001c145,100745,101085,9,0,340,5
0002caf0,100935,101095,3,1,160,5
00044de3,101075,101145,12,3,70,5
0003e975,100915,101205,5,2,290,5
0002cba3,100765,101235,11,1,470,5
0003d7cb,100985,101265,14,2,280,5
00023a86,100975,101275,9,1,300,5
00034362,100765,101305,7,2,540,5
0004a4ee,100855,101305,0,3,450,5
0003d7cb,100985,101405,14,2,420,5
000261f8,101055,101415,9,1,360,5
00040b78,101155,101425,1,3,270,5
0002db04,101075,101455,7,1,380,5
0003fda2,101365,101485,2,2,120,5
00021cb1,101075,101535,14,1,460,5
000302a1,101345,101565,10,2,220,5
000315e3,101455,101605,4,2,150,5
000101a8,101075,101625,15,0,550,5
00021626,101285,101635,3,1,350,5
000236ac,101245,101675,8,1,430,5
000148d1,101515,101755,6,0,240,5
00032fd7,101515,101925,15,2,410,5
0001dd8c,200355,200515,5,0,160,5
0004b1b6,200335,200515,14,3,180,5
00044cc1,200475,200595,12,3,120,5
0002876f,200645,200725,2,1,80,5
00025e65,200395,200765,7,1,370,5
00027a02,200585,200825,13,1,240,5
0003c574,200735,200835,2,2,100,5
0004f7a4,200515,200935,8,3,420,5
0001d6cd,200585,200995,14,0,410,5
0002e676,200675,201055,11,1,380,5
00017093,200695,201155,13,0,460,5
00037173,300445,300565,1,2,120,5
00024126,300515,300625,2,1,110,5
0004b89c,300445,300765,10,3,320,5
00037987,300595,300815,13,2,220,5
00020e5a,300685,300835,4,1,150,5
00030b36,300435,300915,15,2,480,5
00019223,300855,300925,0,0,70,5
0002a4b2,300735,300975,4,1,240,5
0004ac74,300935,301025,3,3,90,5
00023ec9,300875,301065,12,1,190,5
0003dbfb,300975,301095,2,2,120,5
00028023,301075,301165,1,1,90,5
0003f6b1,300785,301175,8,2,390,5
000306bb,300845,301255,6,2,410,5
0001fdb3,300985,301295,12,0,310,5
00042a42,300995,301335,4,3,340,5
0004c123,300955,301545,5,3,590,5
00039dae,301215,301555,0,2,340,5
000304e5,301135,301635,8,2,500,5
0002ad89,301195,301665,7,1,470,5
0003cbed,301135,301675,6,2,540,5
0003e509,400565,400645,3,2,80,5
00017938,400745,400865,4,0,120,5
000215e9,400615,400885,6,1,270,5
0002d4b8,400695,400925,5,1,230,5
0002d620,400805,400985,12,1,180,5
0001f8ca,400885,401105,6,0,220,5
0003a751,400975,401115,1,2,140,5
00037f71,401035,401305,10,2,270,5
0002f2ed,401035,401375,6,1,340,5
00045a34,400955,401375,8,3,420,5
0001c053,155,315,5,0,160,13
0001c053,155,315,5,0,160,13
0003fd0c,100265,100425,13,2,160,13
00044c02,100345,100495,1,3,150,13
000373b9,100335,100525,3,2,190,13
00041496,100225,100595,5,3,370,13
00045d63,100395,100795,15,3,400,13
0003ba21,100455,100805,14,2,350,13
0004bc56,100585,100835,0,3,250,13
00011fbb,100735,100905,6,0,170,13
0004bc56,100585,100975,0,3,390,13
000193f1,100855,101035,12,0,180,13
00029276,100915,101045,1,1,130,13
00040036,101005,101055,3,3,50,13
0002c56c,100645,101125,7,1,480,13
0001a6b7,100545,101155,15,0,610,13
00025c74,100815,101205,8,1,390,13
000396c6,100945,101235,14,2,290,13
0003ea45,100935,101295,5,2,360,13
00042f44,100935,101295,11,3,360,13
00031c7b,100975,101385,7,2,410,13
0001c053,155,315,5,0,160,13
0003fd0c,100265,100425,13,2,160,13
00044c02,100345,100495,1,3,150,13
000373b9,100335,100525,3,2,190,13
00041496,100225,100595,5,3,370,13
00045d63,100395,100795,15,3,400,13
0003ba21,100455,100805,14,2,350,13
0004bc56,100585,100835,0,3,250,13
00011fbb,100735,100905,6,0,170,13
0004bc56,100585,100975,0,3,390,13
000193f1,100855,101035,12,0,180,13
00029276,100915,101045,1,1,130,13
00040036,101005,101055,3,3,50,13
0002c56c,100645,101125,7,1,480,13
0001a6b7,100545,101155,15,0,610,13
00025c74,100815,101205,8,1,390,13
000396c6,100945,101235,14,2,290,13
0003ea45,100935,101295,5,2,360,13
00042f44,100935,101295,11,3,360,13
00031c7b,100975,101385,7,2,410,13
0004cc88,200435,200505,12,3,70,13
00041bb4,200375,200545,14,3,170,13
00024580,200425,200585,3,1,160,13
00043d19,200475,200605,3,3,130,13
0001543b,200555,200625,0,0,70,13
00049fb0,200305,200685,5,3,380,13
0001b559,200735,200815,4,0,80,13
0004259f,200635,200875,15,3,240,13
0001c54d,200475,200925,10,0,450,13
00035e89,200765,201005,13,2,240,13
0003d76c,200655,201105,10,2,450,13
0002d69b,200855,201165,6,1,310,13
0004093f,200915,201175,4,3,260,13
00016467,200995,201245,6,0,250,13
0004e5aa,201095,201275,14,3,180,13
0003edfa,201025,201355,4,2,330,13
00049679,201175,201405,15,3,230,13
00035ba4,201205,201455,13,2,250,13
0004f79a,201325,201465,3,3,140,13
0002ab6e,201265,201505,9,1,240,13
000184c2,201275,201535,3,0,260,13
00021140,201265,201715,9,1,450,13
0001c053,155,315,5,0,160,13
0003fd0c,100265,100425,13,2,160,13
00044c02,100345,100495,1,3,150,13
000373b9,100335,100525,3,2,190,13
00041496,100225,100595,5,3,370,13
00045d63,100395,100795,15,3,400,13
0003ba21,100455,100805,14,2,350,13
0004bc56,100585,100835,0,3,250,13
00011fbb,100735,100905,6,0,170,13
0004bc56,100585,100975,0,3,390,13
000193f1,100855,101035,12,0,180,13
00029276,100915,101045,1,1,130,13
00040036,101005,101055,3,3,50,13
0002c56c,100645,101125,7,1,480,13
0001a6b7,100545,101155,15,0,610,13
00025c74,100815,101205,8,1,390,13
000396c6,100945,101235,14,2,290,13
0003ea45,100935,101295,5,2,360,13
00042f44,100935,101295,11,3,360,13
00031c7b,100975,101385,7,2,410,13
0004cc88,200435,200505,12,3,70,13
00041bb4,200375,200545,14,3,170,13
00024580,200425,200585,3,1,160,13
00043d19,200475,200605,3,3,130,13
0001543b,200555,200625,0,0,70,13
00049fb0,200305,200685,5,3,380,13
0001b559,200735,200815,4,0,80,13
0004259f,200635,200875,15,3,240,13
0001c54d,200475,200925,10,0,450,13
00035e89,200765,201005,13,2,240,13
0003d76c,200655,201105,10,2,450,13
0002d69b,200855,201165,6,1,310,13
0004093f,200915,201175,4,3,260,13
00016467,200995,201245,6,0,250,13
0004e5aa,201095,201275,14,3,180,13
0003edfa,201025,201355,4,2,330,13
00049679,201175,201405,15,3,230,13
00035ba4,201205,201455,13,2,250,13
0004f79a,201325,201465,3,3,140,13
0002ab6e,201265,201505,9,1,240,13
000184c2,201275,201535,3,0,260,13
00021140,201265,201715,9,1,450,13
0002d536,300415,300495,2,1,80,13
0004ed25,300465,300525,12,3,60,13
0001817c,300495,300625,1,0,130,13
00040e80,300485,300645,15,3,160,13
0002106b,300505,300685,13,1,180,13
00044288,300545,300725,12,3,180,13
0001eb98,300625,300885,2,0,260,13
0001d981,300565,301015,11,0,450,13
0001c053,155,315,5,0,160,13
0003fd0c,100265,100425,13,2,160,13
00044c02,100345,100495,1,3,150,13
000373b9,100335,100525,3,2,190,13
00041496,100225,100595,5,3,370,13
00045d63,100395,100795,15,3,400,13
0003ba21,100455,100805,14,2,350,13
0004bc56,100585,100835,0,3,250,13
00011fbb,100735,100905,6,0,170,13
0004bc56,100585,100975,0,3,390,13
000193f1,100855,101035,12,0,180,13
00029276,100915,101045,1,1,130,13
00040036,101005,101055,3,3,50,13
0002c56c,100645,101125,7,1,480,13
0001a6b7,100545,101155,15,0,610,13
00025c74,100815,101205,8,1,390,13
000396c6,100945,101235,14,2,290,13
0003ea45,100935,101295,5,2,360,13
00042f44,100935,101295,11,3,360,13
00031c7b,100975,101385,7,2,410,13
0004cc88,200435,200505,12,3,70,13
00041bb4,200375,200545,14,3,170,13
00024580,200425,200585,3,1,160,13
00043d19,200475,200605,3,3,130,13
0001543b,200555,200625,0,0,70,13
00049fb0,200305,200685,5,3,380,13
0001b559,200735,200815,4,0,80,13
0004259f,200635,200875,15,3,240,13
0001c54d,200475,200925,10,0,450,13
00035e89,200765,201005,13,2,240,13
0003d76c,200655,201105,10,2,450,13
0002d69b,200855,201165,6,1,310,13
0004093f,200915,201175,4,3,260,13
00016467,200995,201245,6,0,250,13
0004e5aa,201095,201275,14,3,180,13
0003edfa,201025,201355,4,2,330,13
00049679,201175,201405,15,3,230,13
00035ba4,201205,201455,13,2,250,13
0004f79a,201325,201465,3,3,140,13
0002ab6e,201265,201505,9,1,240,13
000184c2,201275,201535,3,0,260,13
00021140,201265,201715,9,1,450,13
0002d536,300415,300495,2,1,80,13
0004ed25,300465,300525,12,3,60,13
0001817c,300495,300625,1,0,130,13
00040e80,300485,300645,15,3,160,13
0002106b,300505,300685,13,1,180,13
00044288,300545,300725,12,3,180,13
0001eb98,300625,300885,2,0,260,13
0001d981,300565,301015,11,0,450,13
00032cb8,400575,400675,12,2,100,13
0001a930,400615,400835,6,0,220,13
00024892,400535,400875,8,1,340,13
0001a756,400545,400995,8,0,450,13
00041f7c,400875,401005,1,3,130,13
0001d8be,400735,401075,13,0,340,13
0004bbea,400895,401205,0,3,310,13
000111e8,400665,401215,10,0,550,13
000381a3,400795,401215,9,2,420,13
0003a369,400825,401335,5,2,510,13
00029560,401005,401385,15,1,380,13
0002f12b,401045,401445,5,1,400,13
0004354c,401105,401475,10,3,370,13
0002a93b,401305,401505,3,1,200,13
0004f93f,400935,401515,9,3,580,13
0003b3ae,401255,401605,11,2,350,13
00045d14,401195,401615,4,3,420,13
0003bfaf,401325,401725,3,2,400,13
0004668b,401495,401735,1,3,240,13
000255b6,401405,401755,14,1,350,13
000449c4,401585,401775,3,3,190,13
0004748c,401675,401835,13,3,160,13
000273d1,401695,401985,3,1,290,13
00037e92,401765,401995,0,2,230,13
0001d675,401945,402085,5,0,140,13
000472e6,401975,402095,13,3,120,13
0003b3f9,401805,402115,0,2,310,13
0001d573,401865,402175,12,0,310,13
00038377,401945,402325,10,2,380,13
0001a5f9,401895,402375,10,0,480,13
00028b6f,401945,402385,14,1,440,13
0001586c,401945,402415,11,0,470,13
000156b6,155,335,12,0,180,15
000156b6,155,335,12,0,180,15
00011c03,100205,100305,4,0,100,15
0002a234,100265,100585,15,1,320,15
00010cd6,100375,100595,6,0,220,15
0004910d,100355,100705,9,3,350,15
00022222,100565,100735,5,1,170,15
0001941e,100335,100885,11,0,550,15
0002b613,100675,100895,3,1,220,15
0002243a,100445,100935,15,1,490,15
00025f9a,100605,101055,7,1,450,15
0001aed9,100525,101105,11,0,580,15
000156b6,155,335,12,0,180,15
00011c03,100205,100305,4,0,100,15
0002a234,100265,100585,15,1,320,15
00010cd6,100375,100595,6,0,220,15
0004910d,100355,100705,9,3,350,15
00022222,100565,100735,5,1,170,15
0001941e,100335,100885,11,0,550,15
0002b613,100675,100895,3,1,220,15
0002243a,100445,100935,15,1,490,15
00025f9a,100605,101055,7,1,450,15
0001aed9,100525,101105,11,0,580,15
00028c01,200335,200415,2,1,80,15
000128e3,200355,200455,4,0,100,15
0003d711,200395,200605,0,2,210,15
0003c713,200615,200695,12,2,80,15
0004f8a4,200565,200705,13,3,140,15
0004ed54,200445,200785,5,3,340,15
00030a38,200695,200795,2,2,100,15
000137e2,200765,200815,0,0,50,15
0004216a,200495,200925,6,3,430,15
0002d9d9,200565,200965,8,1,400,15
0001b992,200835,200975,5,0,140,15
000278ee,200815,201095,9,1,280,15
0001f6d6,200915,201125,3,0,210,15
0004c445,201005,201185,14,3,180,15
00016ebb,200915,201275,12,0,360,15
000156b6,155,335,12,0,180,15
00011c03,100205,100305,4,0,100,15
0002a234,100265,100585,15,1,320,15
00010cd6,100375,100595,6,0,220,15
0004910d,100355,100705,9,3,350,15
00022222,100565,100735,5,1,170,15
0001941e,100335,100885,11,0,550,15
0002b613,100675,100895,3,1,220,15
0002243a,100445,100935,15,1,490,15
00025f9a,100605,101055,7,1,450,15
0001aed9,100525,101105,11,0,580,15
00028c01,200335,200415,2,1,80,15
000128e3,200355,200455,4,0,100,15
0003d711,200395,200605,0,2,210,15
0003c713,200615,200695,12,2,80,15
0004f8a4,200565,200705,13,3,140,15
0004ed54,200445,200785,5,3,340,15
00030a38,200695,200795,2,2,100,15
000137e2,200765,200815,0,0,50,15
0004216a,200495,200925,6,3,430,15
0002d9d9,200565,200965,8,1,400,15
0001b992,200835,200975,5,0,140,15
000278ee,200815,201095,9,1,280,15
0001f6d6,200915,201125,3,0,210,15
0004c445,201005,201185,14,3,180,15
00016ebb,200915,201275,12,0,360,15
00047955,300396,300435,3,3,39,15
00032dc3,300465,300625,13,2,160,15
00013618,300655,300815,5,0,160,15
00027f62,300555,300895,8,1,340,15
00011c14,300615,300945,14,0,330,15
00015266,300825,301025,2,0,200,15
00033147,300825,301055,2,2,230,15
00034a3b,300855,301115,13,2,260,15
00015266,300825,301145,2,0,320,15
0002b6da,300825,301155,6,1,330,15
0003fbb3,301025,301155,1,2,130,15
00031e47,300735,301235,9,2,500,15
0001d2cd,300845,301255,3,0,410,15
00029761,300825,301275,6,1,450,15
000184a4,300925,301295,7,0,370,15
00033427,300865,301335,15,2,470,15
00035e7e,300955,301435,5,2,480,15
000156b6,155,335,12,0,180,15
00011c03,100205,100305,4,0,100,15
0002a234,100265,100585,15,1,320,15
00010cd6,100375,100595,6,0,220,15
0004910d,100355,100705,9,3,350,15
00022222,100565,100735,5,1,170,15
0001941e,100335,100885,11,0,550,15
0002b613,100675,100895,3,1,220,15
0002243a,100445,100935,15,1,490,15
00025f9a,100605,101055,7,1,450,15
0001aed9,100525,101105,11,0,580,15
00028c01,200335,200415,2,1,80,15
000128e3,200355,200455,4,0,100,15
0003d711,200395,200605,0,2,210,15
0003c713,200615,200695,12,2,80,15
0004f8a4,200565,200705,13,3,140,15
0004ed54,200445,200785,5,3,340,15
00030a38,200695,200795,2,2,100,15
000137e2,200765,200815,0,0,50,15
0004216a,200495,200925,6,3,430,15
0002d9d9,200565,200965,8,1,400,15
0001b992,200835,200975,5,0,140,15
000278ee,200815,201095,9,1,280,15
0001f6d6,200915,201125,3,0,210,15
0004c445,201005,201185,14,3,180,15
00016ebb,200915,201275,12,0,360,15
00047955,300396,300435,3,3,39,15
00032dc3,300465,300625,13,2,160,15
00013618,300655,300815,5,0,160,15
00027f62,300555,300895,8,1,340,15
00011c14,300615,300945,14,0,330,15
00015266,300825,301025,2,0,200,15
00033147,300825,301055,2,2,230,15
00034a3b,300855,301115,13,2,260,15
00015266,300825,301145,2,0,320,15
0002b6da,300825,301155,6,1,330,15
0003fbb3,301025,301155,1,2,130,15
00031e47,300735,301235,9,2,500,15
0001d2cd,300845,301255,3,0,410,15
00029761,300825,301275,6,1,450,15
000184a4,300925,301295,7,0,370,15
00033427,300865,301335,15,2,470,15
00035e7e,300955,301435,5,2,480,15
0002813c,400575,400615,1,1,40,15
00036d72,400645,400825,1,2,180,15
00030e7f,400735,400905,13,2,170,15
0003336d,400645,400945,1,2,300,15
00033d41,125,405,15,2,280,11
00033d41,125,405,15,2,280,11
00014e7d,100385,100465,1,0,80,11
0002d6e5,100335,100505,13,1,170,11
000152c4,100485,100555,4,0,70,11
00046c9e,100225,100565,15,3,340,11
00034cf1,100295,100635,15,2,340,11
0002ff14,100535,100745,5,1,210,11
00011acc,100455,100775,12,0,320,11
000283d9,100675,100825,12,1,150,11
00034d91,100715,100865,2,2,150,11
00019cd8,100675,100895,1,0,220,11
00027aa0,100725,100965,5,1,240,11
00021b00,100895,101065,2,1,170,11
0004a8a2,100565,101115,8,3,550,11
00032d2b,100825,101165,6,2,340,11
00033d41,125,405,15,2,280,11
00014e7d,100385,100465,1,0,80,11
0002d6e5,100335,100505,13,1,170,11
000152c4,100485,100555,4,0,70,11
00046c9e,100225,100565,15,3,340,11
00034cf1,100295,100635,15,2,340,11
0002ff14,100535,100745,5,1,210,11
00011acc,100455,100775,12,0,320,11
000283d9,100675,100825,12,1,150,11
00034d91,100715,100865,2,2,150,11
00019cd8,100675,100895,1,0,220,11
00027aa0,100725,100965,5,1,240,11
00021b00,100895,101065,2,1,170,11
0004a8a2,100565,101115,8,3,550,11
00032d2b,100825,101165,6,2,340,11
0004e4cc,100775,101235,5,3,460,11
00018d2d,100615,101355,14,0,740,11
00047089,101295,101365,2,3,70,11
000281dd,100585,101385,11,1,800,11
00023dce,101135,101425,9,1,290,11
000310e0,101175,101425,4,2,250,11
000120e8,101065,101505,11,0,440,11
0001cc1d,100985,101585,12,0,600,11
0001da3f,101245,101665,9,0,420,11
0003e34c,100975,101685,15,2,710,11
00017ca2,101335,101705,10,0,370,11
0002ea1d,101045,101725,12,1,680,11
0001a329,100735,101785,15,0,1050,11
00017ca2,101335,101825,10,0,490,11
0001f98c,200455,200495,0,0,40,11
00022a47,200505,200585,2,1,80,11
00031561,200335,200615,4,2,280,11
00011f56,200635,200705,0,0,70,11
0002fddf,200565,200705,2,1,140,11
0003ad31,200385,200735,5,2,350,11
0002a2e6,200525,200835,7,1,310,11
00023d53,200775,200915,3,1,140,11
0002ad98,200855,200975,4,1,120,11
0003a7cd,200965,201035,2,2,70,11
0003f27d,200895,201075,3,2,180,11
00034a65,200825,201115,14,2,290,11
000270bd,200725,201145,10,1,420,11
00039cee,200985,201215,12,2,230,11
00048899,200845,201245,6,3,400,11
00037cc0,200715,201255,9,2,540,11
00039a2b,201015,201335,12,2,320,11
00033d41,125,405,15,2,280,11
00014e7d,100385,100465,1,0,80,11
0002d6e5,100335,100505,13,1,170,11
000152c4,100485,100555,4,0,70,11
00046c9e,100225,100565,15,3,340,11
00034cf1,100295,100635,15,2,340,11
0002ff14,100535,100745,5,1,210,11
00011acc,100455,100775,12,0,320,11
000283d9,100675,100825,12,1,150,11
00034d91,100715,100865,2,2,150,11
00019cd8,100675,100895,1,0,220,11
00027aa0,100725,100965,5,1,240,11
00021b00,100895,101065,2,1,170,11
0004a8a2,100565,101115,8,3,550,11
00032d2b,100825,101165,6,2,340,11
0004e4cc,100775,101235,5,3,460,11
00018d2d,100615,101355,14,0,740,11
00047089,101295,101365,2,3,70,11
000281dd,100585,101385,11,1,800,11
00023dce,101135,101425,9,1,290,11
000310e0,101175,101425,4,2,250,11
000120e8,101065,101505,11,0,440,11
0001cc1d,100985,101585,12,0,600,11
0001da3f,101245,101665,9,0,420,11
0003e34c,100975,101685,15,2,710,11
00017ca2,101335,101705,10,0,370,11
0002ea1d,101045,101725,12,1,680,11
0001a329,100735,101785,15,0,1050,11
00017ca2,101335,101825,10,0,490,11
0001f98c,200455,200495,0,0,40,11
00022a47,200505,200585,2,1,80,11
00031561,200335,200615,4,2,280,11
00011f56,200635,200705,0,0,70,11
0002fddf,200565,200705,2,1,140,11
0003ad31,200385,200735,5,2,350,11
0002a2e6,200525,200835,7,1,310,11
00023d53,200775,200915,3,1,140,11
0002ad98,200855,200975,4,1,120,11
0003a7cd,200965,201035,2,2,70,11
0003f27d,200895,201075,3,2,180,11
00034a65,200825,201115,14,2,290,11
000270bd,200725,201145,10,1,420,11
00039cee,200985,201215,12,2,230,11
00048899,200845,201245,6,3,400,11
00037cc0,200715,201255,9,2,540,11
00039a2b,201015,201335,12,2,320,11
0003962d,300475,300575,12,2,100,11
0001f3c4,300435,300735,9,0,300,11
000213fc,300725,300815,4,1,90,11
00044d3e,300765,300835,3,3,70,11
0001cfef,300645,300855,6,0,210,11
00016a49,300785,300895,4,0,110,11
000264ac,300555,300895,9,1,340,11
00039d18,300475,300925,15,2,450,11
0001266a,300515,300955,12,0,440,11
0001cfef,300645,300995,6,0,350,11
0002262e,300515,300995,15,1,480,11
0004d450,300785,301025,10,3,240,11
00024430,300955,301065,4,1,110,11
00030937,300785,301085,13,2,300,11
00033d41,125,405,15,2,280,11
00014e7d,100385,100465,1,0,80,11
0002d6e5,100335,100505,13,1,170,11
000152c4,100485,100555,4,0,70,11
00046c9e,100225,100565,15,3,340,11
00034cf1,100295,100635,15,2,340,11
0002ff14,100535,100745,5,1,210,11
00011acc,100455,100775,12,0,320,11
000283d9,100675,100825,12,1,150,11
00034d91,100715,100865,2,2,150,11
00019cd8,100675,100895,1,0,220,11
00027aa0,100725,100965,5,1,240,11
00021b00,100895,101065,2,1,170,11
0004a8a2,100565,101115,8,3,550,11
00032d2b,100825,101165,6,2,340,11
0004e4cc,100775,101235,5,3,460,11
00018d2d,100615,101355,14,0,740,11
00047089,101295,101365,2,3,70,11
000281dd,100585,101385,11,1,800,11
00023dce,101135,101425,9,1,290,11
000310e0,101175,101425,4,2,250,11
000120e8,101065,101505,11,0,440,11
0001cc1d,100985,101585,12,0,600,11
0001da3f,101245,101665,9,0,420,11
0003e34c,100975,101685,15,2,710,11
00017ca2,101335,101705,10,0,370,11
0002ea1d,101045,101725,12,1,680,11
0001a329,100735,101785,15,0,1050,11
00017ca2,101335,101825,10,0,490,11
0001f98c,200455,200495,0,0,40,11
00022a47,200505,200585,2,1,80,11
00031561,200335,200615,4,2,280,11
00011f56,200635,200705,0,0,70,11
0002fddf,200565,200705,2,1,140,11
0003ad31,200385,200735,5,2,350,11
0002a2e6,200525,200835,7,1,310,11
00023d53,200775,200915,3,1,140,11
0002ad98,200855,200975,4,1,120,11
0003a7cd,200965,201035,2,2,70,11
0003f27d,200895,201075,3,2,180,11
00034a65,200825,201115,14,2,290,11
000270bd,200725,201145,10,1,420,11
00039cee,200985,201215,12,2,230,11
00048899,200845,201245,6,3,400,11
00037cc0,200715,201255,9,2,540,11
00039a2b,201015,201335,12,2,320,11
0003962d,300475,300575,12,2,100,11
0001f3c4,300435,300735,9,0,300,11
000213fc,300725,300815,4,1,90,11
00044d3e,300765,300835,3,3,70,11
0001cfef,300645,300855,6,0,210,11
00016a49,300785,300895,4,0,110,11
000264ac,300555,300895,9,1,340,11
00039d18,300475,300925,15,2,450,11
0001266a,300515,300955,12,0,440,11
0001cfef,300645,300995,6,0,350,11
0002262e,300515,300995,15,1,480,11
0004d450,300785,301025,10,3,240,11
00024430,300955,301065,4,1,110,11
00030937,300785,301085,13,2,300,11
0004aeba,300915,301175,15,3,260,11
00036535,300855,301185,11,2,330,11
00036189,300845,301295,10,2,450,11
000254f7,301035,301335,9,1,300,11
0003dcd6,300635,301335,7,2,700,11
0004d2db,301105,301375,11,3,270,11
000291cb,301225,301445,3,1,220,11
0001e5c4,301125,301555,9,0,430,11
00045a86,301215,301565,15,3,350,11
00039804,301125,301575,8,2,450,11
0002c656,301285,301585,12,1,300,11
000189f4,301215,301595,6,0,380,11
00043b01,301145,301665,10,3,520,11
0004cd7c,301215,301865,7,3,650,11
0004e051,301295,302065,6,3,770,11
00011679,400555,400705,3,0,150,11
00020b97,400645,400815,4,1,170,11
0001d999,400825,400985,4,0,160,11
000287da,400735,401015,13,1,280,11
00048a91,400665,401025,4,3,360,11
0002b92b,400985,401115,3,1,130,11
00024ae9,400905,401155,5,1,250,11
0004e837,400755,401205,6,3,450,11
00020db2,155,195,1,1,40,16
00020db2,155,195,1,1,40,16
0003642c,100275,100475,0,2,200,16
00038f67,100365,100625,4,2,260,16
00037609,100565,100665,2,2,100,16
0003a6e8,100645,100755,1,2,110,16
0001db55,100455,100785,7,0,330,16
000435b0,100555,100815,11,3,260,16
000326ee,100395,100825,7,2,430,16
0003f53b,100685,100865,0,2,180,16
0003bf1e,100575,100965,9,2,390,16
000412a4,100675,100965,5,3,290,16
0001b651,100675,101055,7,0,380,16
00041b82,100545,101065,7,3,520,16
00024ea7,100685,101075,8,1,390,16
0003a29e,100765,101075,5,2,310,16
00026e3e,100835,101175,13,1,340,16
0004dbf1,100745,101215,15,3,470,16
0002c541,100885,101435,15,1,550,16
00020db2,155,195,1,1,40,16
0003642c,100275,100475,0,2,200,16
00038f67,100365,100625,4,2,260,16
00037609,100565,100665,2,2,100,16
0003a6e8,100645,100755,1,2,110,16
0001db55,100455,100785,7,0,330,16
000435b0,100555,100815,11,3,260,16
000326ee,100395,100825,7,2,430,16
0003f53b,100685,100865,0,2,180,16
0003bf1e,100575,100965,9,2,390,16
000412a4,100675,100965,5,3,290,16
0001b651,100675,101055,7,0,380,16
00041b82,100545,101065,7,3,520,16
00024ea7,100685,101075,8,1,390,16
0003a29e,100765,101075,5,2,310,16
00026e3e,100835,101175,13,1,340,16
0004dbf1,100745,101215,15,3,470,16
0002c541,100885,101435,15,1,550,16
000488db,200365,200405,3,3,40,16
00034a33,200385,200505,1,2,120,16
00020db2,155,195,1,1,40,16
0003642c,100275,100475,0,2,200,16
00038f67,100365,100625,4,2,260,16
00037609,100565,100665,2,2,100,16
0003a6e8,100645,100755,1,2,110,16
0001db55,100455,100785,7,0,330,16
000435b0,100555,100815,11,3,260,16
000326ee,100395,100825,7,2,430,16
0003f53b,100685,100865,0,2,180,16
0003bf1e,100575,100965,9,2,390,16
000412a4,100675,100965,5,3,290,16
0001b651,100675,101055,7,0,380,16
00041b82,100545,101065,7,3,520,16
00024ea7,100685,101075,8,1,390,16
0003a29e,100765,101075,5,2,310,16
00026e3e,100835,101175,13,1,340,16
0004dbf1,100745,101215,15,3,470,16
0002c541,100885,101435,15,1,550,16
000488db,200365,200405,3,3,40,16
00034a33,200385,200505,1,2,120,16
0003557d,300435,300535,12,2,100,16
00034abc,300505,300735,10,2,230,16
0001a5d3,300595,300755,5,0,160,16
0002df06,300535,300855,15,1,320,16
00045741,300815,300855,12,3,40,16
0003ecfb,300715,300915,3,2,200,16
0002de2d,300755,300995,5,1,240,16
0002feba,300665,301035,11,1,370,16
0002dc3b,300885,301095,4,1,210,16
0003f991,300965,301355,8,2,390,16
00035d87,301175,301475,4,2,300,16
00019a61,300975,301515,14,0,540,16
0003cee1,301405,301515,2,2,110,16
0003c4b1,301225,301575,0,2,350,16
000285b7,301055,301615,6,1,560,16
0001da07,301475,301665,6,0,190,16
000200bc,301465,301715,5,1,250,16
0001a80d,301435,301745,2,0,310,16
0002b341,301765,301855,0,1,90,16
00011d81,301315,301875,12,0,560,16
0004c325,301405,301875,0,3,470,16
0002dba0,301135,301915,14,1,780,16
000233d7,301535,301955,14,1,420,16
000379c0,301585,301995,14,2,410,16
00029495,301605,302035,3,1,430,16
000236f2,301655,302155,3,1,500,16
00046799,301765,302205,10,3,440,16
0004fb0f,301755,302245,8,3,490,16
0002e928,301565,302255,11,1,690,16
00020db2,155,195,1,1,40,16
0003642c,100275,100475,0,2,200,16
00038f67,100365,100625,4,2,260,16
00037609,100565,100665,2,2,100,16
0003a6e8,100645,100755,1,2,110,16
0001db55,100455,100785,7,0,330,16
000435b0,100555,100815,11,3,260,16
000326ee,100395,100825,7,2,430,16
0003f53b,100685,100865,0,2,180,16
0003bf1e,100575,100965,9,2,390,16
000412a4,100675,100965,5,3,290,16
0001b651,100675,101055,7,0,380,16
00041b82,100545,101065,7,3,520,16
00024ea7,100685,101075,8,1,390,16
0003a29e,100765,101075,5,2,310,16
00026e3e,100835,101175,13,1,340,16
0004dbf1,100745,101215,15,3,470,16
0002c541,100885,101435,15,1,550,16
000488db,200365,200405,3,3,40,16
00034a33,200385,200505,1,2,120,16
0003557d,300435,300535,12,2,100,16
00034abc,300505,300735,10,2,230,16
0001a5d3,300595,300755,5,0,160,16
0002df06,300535,300855,15,1,320,16
00045741,300815,300855,12,3,40,16
0003ecfb,300715,300915,3,2,200,16
0002de2d,300755,300995,5,1,240,16
0002feba,300665,301035,11,1,370,16
0002dc3b,300885,301095,4,1,210,16
0003f991,300965,301355,8,2,390,16
00035d87,301175,301475,4,2,300,16
00019a61,300975,301515,14,0,540,16
0003cee1,301405,301515,2,2,110,16
0003c4b1,301225,301575,0,2,350,16
000285b7,301055,301615,6,1,560,16
0001da07,301475,301665,6,0,190,16
000200bc,301465,301715,5,1,250,16
0001a80d,301435,301745,2,0,310,16
0002b341,301765,301855,0,1,90,16
00011d81,301315,301875,12,0,560,16
0004c325,301405,301875,0,3,470,16
0002dba0,301135,301915,14,1,780,16
000233d7,301535,301955,14,1,420,16
000379c0,301585,301995,14,2,410,16
00029495,301605,302035,3,1,430,16
000236f2,301655,302155,3,1,500,16
00046799,301765,302205,10,3,440,16
0004fb0f,301755,302245,8,3,490,16
0002e928,301565,302255,11,1,690,16
00028e1f,301745,302355,11,1,610,16
0002b010,400585,400815,6,1,230,16
0002b010,400585,400915,6,1,330,16
0003d5d9,400675,401135,6,2,460,16
0001ec88,96,175,1,0,79,14
0001ec88,96,175,1,0,79,14
0003d67f,100285,100325,2,2,40,14
00025578,100415,100615,13,1,200,14
0004e046,100515,100655,14,3,140,14
0002bb00,100535,100675,2,1,140,14
00022627,100375,100715,10,1,340,14
000341ee,100615,100825,5,2,210,14
00017903,100495,100845,15,0,350,14
00029b86,100565,100855,13,1,290,14
00044252,100425,100865,7,3,440,14
000407d7,100865,100935,3,3,70,14
0004b296,100775,101025,4,3,250,14
00035fbd,100675,101085,5,2,410,14
0003c0f0,100725,101125,8,2,400,14
0001704e,100695,101135,9,0,440,14
000391f3,101185,101235,2,2,50,14
00021311,100955,101265,9,1,310,14
00027a91,101115,101305,0,1,190,14
000384d1,101245,101305,12,2,60,14
0001c766,101025,101345,7,0,320,14
00024132,100985,101385,7,1,400,14
0003c9af,100985,101415,15,2,430,14
00029cb0,100745,101425,8,1,680,14
00025e6c,101235,101525,4,1,290,14
0001ec88,96,175,1,0,79,14
0003d67f,100285,100325,2,2,40,14
00025578,100415,100615,13,1,200,14
0004e046,100515,100655,14,3,140,14
0002bb00,100535,100675,2,1,140,14
00022627,100375,100715,10,1,340,14
000341ee,100615,100825,5,2,210,14
00017903,100495,100845,15,0,350,14
00029b86,100565,100855,13,1,290,14
00044252,100425,100865,7,3,440,14
000407d7,100865,100935,3,3,70,14
0004b296,100775,101025,4,3,250,14
00035fbd,100675,101085,5,2,410,14
0003c0f0,100725,101125,8,2,400,14
0001704e,100695,101135,9,0,440,14
000391f3,101185,101235,2,2,50,14
00021311,100955,101265,9,1,310,14
00027a91,101115,101305,0,1,190,14
000384d1,101245,101305,12,2,60,14
0001c766,101025,101345,7,0,320,14
00024132,100985,101385,7,1,400,14
0003c9af,100985,101415,15,2,430,14
00029cb0,100745,101425,8,1,680,14
00025e6c,101235,101525,4,1,290,14
000231e7,200475,200555,2,1,80,14
0003dfc1,200495,200615,2,2,120,14
0003b769,200385,200655,15,2,270,14
00026576,200435,200735,10,1,300,14
0002668a,200605,200775,0,1,170,14
0004274f,200685,200835,13,3,150,14
0001cb44,200575,200895,9,0,320,14
000206e7,200635,200895,4,1,260,14
00012cbf,200905,200975,4,0,70,14
0002bf84,200635,201025,7,1,390,14
00034c49,200755,201065,14,2,310,14
00047a32,200595,201075,9,3,480,14
0002a965,200585,201085,14,1,500,14
0003b8b3,201055,201125,2,2,70,14
00031de0,201115,201195,12,2,80,14
000468c6,200955,201195,13,3,240,14
0002da48,200965,201245,5,1,280,14
00049b7e,200845,201315,5,3,470,14
0001ec88,96,175,1,0,79,14
0003d67f,100285,100325,2,2,40,14
00025578,100415,100615,13,1,200,14
0004e046,100515,100655,14,3,140,14
0002bb00,100535,100675,2,1,140,14
00022627,100375,100715,10,1,340,14
000341ee,100615,100825,5,2,210,14
00017903,100495,100845,15,0,350,14
00029b86,100565,100855,13,1,290,14
00044252,100425,100865,7,3,440,14
000407d7,100865,100935,3,3,70,14
0004b296,100775,101025,4,3,250,14
00035fbd,100675,101085,5,2,410,14
0003c0f0,100725,101125,8,2,400,14
0001704e,100695,101135,9,0,440,14
000391f3,101185,101235,2,2,50,14
00021311,100955,101265,9,1,310,14
00027a91,101115,101305,0,1,190,14
000384d1,101245,101305,12,2,60,14
0001c766,101025,101345,7,0,320,14
00024132,100985,101385,7,1,400,14
0003c9af,100985,101415,15,2,430,14
00029cb0,100745,101425,8,1,680,14
00025e6c,101235,101525,4,1,290,14
000231e7,200475,200555,2,1,80,14
0003dfc1,200495,200615,2,2,120,14
0003b769,200385,200655,15,2,270,14
00026576,200435,200735,10,1,300,14
0002668a,200605,200775,0,1,170,14
0004274f,200685,200835,13,3,150,14
0001cb44,200575,200895,9,0,320,14
000206e7,200635,200895,4,1,260,14
00012cbf,200905,200975,4,0,70,14
0002bf84,200635,201025,7,1,390,14
00034c49,200755,201065,14,2,310,14
00047a32,200595,201075,9,3,480,14
0002a965,200585,201085,14,1,500,14
0003b8b3,201055,201125,2,2,70,14
00031de0,201115,201195,12,2,80,14
000468c6,200955,201195,13,3,240,14
0002da48,200965,201245,5,1,280,14
00049b7e,200845,201315,5,3,470,14
00042982,201175,201445,1,3,270,14
000334c5,201225,201455,11,2,230,14
00012ce7,201285,201485,1,0,200,14
0001b29c,200915,201585,15,0,670,14
0003b5c4,201325,201665,9,2,340,14
0002dac4,201175,201705,14,1,530,14
0002d2b8,201395,201815,13,1,420,14
0003fdb7,300475,300745,10,2,270,14
00044492,300405,300745,4,3,340,14
0004118b,300775,300825,12,3,50,14
0003bc37,300705,300855,3,2,150,14
00010f88,300565,300895,14,0,330,14
0003c6ca,300865,300915,1,2,50,14
0003c6ca,300865,301015,1,2,150,14
00039e04,300985,301115,13,2,130,14
00032d4c,300825,301155,6,2,330,14
00013a7e,300955,301285,7,0,330,14
0004a870,300865,301305,8,3,440,14
0004aa7b,301395,301465,3,3,70,14
00022efe,301125,301495,10,1,370,14
00044cf1,301275,301565,0,3,290,14
0001000e,301565,301605,0,0,40,14
00038285,301305,301615,14,2,310,14
0004cf25,301495,301625,12,3,130,14
00019022,301185,301645,14,0,460,14
00034d71,301635,301745,3,2,110,14
00049570,301055,301775,6,3,720,14
00032d76,301395,301785,11,2,390,14
0004b4ed,301495,301855,15,3,360,14
00037201,301475,301915,15,2,440,14
0002bef7,301665,301945,9,1,280,14
000471a6,301775,302085,5,3,310,14
00042767,301855,302125,0,3,270,14
000396e5,301695,302175,8,2,480,14
000112e4,301735,302315,15,0,580,14
0001ec88,96,175,1,0,79,14
0003d67f,100285,100325,2,2,40,14
00025578,100415,100615,13,1,200,14
0004e046,100515,100655,14,3,140,14
0002bb00,100535,100675,2,1,140,14
00022627,100375,100715,10,1,340,14
000341ee,100615,100825,5,2,210,14
00017903,100495,100845,15,0,350,14
00029b86,100565,100855,13,1,290,14
00044252,100425,100865,7,3,440,14
000407d7,100865,100935,3,3,70,14
0004b296,100775,101025,4,3,250,14
00035fbd,100675,101085,5,2,410,14
0003c0f0,100725,101125,8,2,400,14
0001704e,100695,101135,9,0,440,14
000391f3,101185,101235,2,2,50,14
00021311,100955,101265,9,1,310,14
00027a91,101115,101305,0,1,190,14
000384d1,101245,101305,12,2,60,14
0001c766,101025,101345,7,0,320,14
00024132,100985,101385,7,1,400,14
0003c9af,100985,101415,15,2,430,14
00029cb0,100745,101425,8,1,680,14
00025e6c,101235,101525,4,1,290,14
000231e7,200475,200555,2,1,80,14
0003dfc1,200495,200615,2,2,120,14
0003b769,200385,200655,15,2,270,14
00026576,200435,200735,10,1,300,14
0002668a,200605,200775,0,1,170,14
0004274f,200685,200835,13,3,150,14
0001cb44,200575,200895,9,0,320,14
000206e7,200635,200895,4,1,260,14
00012cbf,200905,200975,4,0,70,14
0002bf84,200635,201025,7,1,390,14
00034c49,200755,201065,14,2,310,14
00047a32,200595,201075,9,3,480,14
0002a965,200585,201085,14,1,500,14
0003b8b3,201055,201125,2,2,70,14
00031de0,201115,201195,12,2,80,14
000468c6,200955,201195,13,3,240,14
0002da48,200965,201245,5,1,280,14
00049b7e,200845,201315,5,3,470,14
00042982,201175,201445,1,3,270,14
000334c5,201225,201455,11,2,230,14
00012ce7,201285,201485,1,0,200,14
0001b29c,200915,201585,15,0,670,14
0003b5c4,201325,201665,9,2,340,14
0002dac4,201175,201705,14,1,530,14
0002d2b8,201395,201815,13,1,420,14
0003fdb7,300475,300745,10,2,270,14
00044492,300405,300745,4,3,340,14
0004118b,300775,300825,12,3,50,14
0003bc37,300705,300855,3,2,150,14
00010f88,300565,300895,14,0,330,14
0003c6ca,300865,300915,1,2,50,14
0003c6ca,300865,301015,1,2,150,14
00039e04,300985,301115,13,2,130,14
00032d4c,300825,301155,6,2,330,14
00013a7e,300955,301285,7,0,330,14
0004a870,300865,301305,8,3,440,14
0004aa7b,301395,301465,3,3,70,14
00022efe,301125,301495,10,1,370,14
00044cf1,301275,301565,0,3,290,14
0001000e,301565,301605,0,0,40,14
00038285,301305,301615,14,2,310,14
0004cf25,301495,301625,12,3,130,14
00019022,301185,301645,14,0,460,14
00034d71,301635,301745,3,2,110,14
00049570,301055,301775,6,3,720,14
00032d76,301395,301785,11,2,390,14
0004b4ed,301495,301855,15,3,360,14
00037201,301475,301915,15,2,440,14
0002bef7,301665,301945,9,1,280,14
000471a6,301775,302085,5,3,310,14
00042767,301855,302125,0,3,270,14
000396e5,301695,302175,8,2,480,14
000112e4,301735,302315,15,0,580,14
000379dc,400515,400675,13,2,160,14
00019207,400575,400775,6,0,200,14
0004f939,400496,400795,0,3,299,14
00027edb,400725,400825,2,1,100,14
0003dff7,400555,400835,1,2,280,14
00015c10,400755,400855,1,0,100,14
00022a08,400545,400865,10,1,320,14
00036dbf,400635,400935,11,2,300,14
000245fb,400775,400945,2,1,170,14
0004ad30,400535,401065,0,3,530,14
00038acd,400805,401075,10,2,270,14
000264fd,400835,401085,6,1,250,14
000340bb,401055,401155,2,2,100,14
000435e3,400925,401205,1,3,280,14
00031148,400775,401215,7,2,440,14
0001706f,401025,401235,1,0,210,14
00032010,400975,401315,5,2,340,14
00019c4c,185,345,5,0,160,5
00019c4c,185,345,5,0,160,5
00022502,100295,100545,14,1,250,5
00031724,100285,100615,6,2,330,5
00014442,100385,100685,9,0,300,5
0004da71,100485,100685,11,3,200,5
00038f40,100535,100695,3,2,160,5
000271eb,100405,100785,10,1,380,5
0001972f,100685,100795,1,0,110,5
0004f78b,100615,101005,8,3,390,5
0002a831,100765,101045,5,1,280,5
0002d15d,100765,101085,3,1,320,5
00029a90,101095,101165,1,1,70,5
00029c1d,101015,101205,2,1,190,5
0003d9eb,101095,101215,3,2,120,5
0004b1bb,100945,101225,4,3,280,5
0001daf3,100835,101285,9,0,450,5
0002cf0f,100895,101345,9,1,450,5
0004183c,101175,101345,3,3,170,5
0003de7d,100945,101375,11,2,430,5
00023fcd,101155,101445,13,1,290,5
0004bb48,101225,101525,15,3,300,5
00020a9f,101095,101545,9,1,450,5
00019c4c,185,345,5,0,160,5
00022502,100295,100545,14,1,250,5
00031724,100285,100615,6,2,330,5
00014442,100385,100685,9,0,300,5
0004da71,100485,100685,11,3,200,5
00038f40,100535,100695,3,2,160,5
000271eb,100405,100785,10,1,380,5
0001972f,100685,100795,1,0,110,5
0004f78b,100615,101005,8,3,390,5
0002a831,100765,101045,5,1,280,5
0002d15d,100765,101085,3,1,320,5
00029a90,101095,101165,1,1,70,5
00029c1d,101015,101205,2,1,190,5
0003d9eb,101095,101215,3,2,120,5
0004b1bb,100945,101225,4,3,280,5
0001daf3,100835,101285,9,0,450,5
0002cf0f,100895,101345,9,1,450,5
0004183c,101175,101345,3,3,170,5
0003de7d,100945,101375,11,2,430,5
00023fcd,101155,101445,13,1,290,5
0004bb48,101225,101525,15,3,300,5
00020a9f,101095,101545,9,1,450,5
0001c622,200375,200715,10,0,340,5
00049ad3,200615,200735,2,3,120,5
00027774,200465,200815,10,1,350,5
0001d0b3,200565,200845,12,0,280,5
0001813d,200735,200885,5,0,150,5
0001c026,200815,200985,1,0,170,5
0003d6be,200455,200985,7,2,530,5
0002a6bf,200665,200995,14,1,330,5
0001af17,200695,201025,6,0,330,5
00023437,200545,201035,14,1,490,5
0002a1c3,200805,201075,4,1,270,5
0001019a,200735,201125,2,0,390,5
00034b2f,201035,201195,12,2,160,5
0001fbf7,200735,201225,11,0,490,5
00027f9a,200735,201255,11,1,520,5
000380a7,200855,201255,4,2,400,5
00028f8e,200945,201295,8,1,350,5
0003471e,201115,201315,12,2,200,5
000182bc,200845,201425,10,0,580,5
00016809,201305,201575,2,0,270,5
0001effb,201365,201615,7,0,250,5
00021a7a,201275,201625,9,1,350,5
00042c94,201445,201655,1,3,210,5
0001334b,201205,201695,3,0,490,5
00022917,201425,201705,12,1,280,5
000177af,201315,201735,10,0,420,5
0003b1c6,201425,202015,6,2,590,5
00019c4c,185,345,5,0,160,5
00022502,100295,100545,14,1,250,5
00031724,100285,100615,6,2,330,5
00014442,100385,100685,9,0,300,5
0004da71,100485,100685,11,3,200,5
00038f40,100535,100695,3,2,160,5
000271eb,100405,100785,10,1,380,5
0001972f,100685,100795,1,0,110,5
0004f78b,100615,101005,8,3,390,5
0002a831,100765,101045,5,1,280,5
0002d15d,100765,101085,3,1,320,5
00029a90,101095,101165,1,1,70,5
00029c1d,101015,101205,2,1,190,5
0003d9eb,101095,101215,3,2,120,5
0004b1bb,100945,101225,4,3,280,5
0001daf3,100835,101285,9,0,450,5
0002cf0f,100895,101345,9,1,450,5
0004183c,101175,101345,3,3,170,5
0003de7d,100945,101375,11,2,430,5
00023fcd,101155,101445,13,1,290,5
0004bb48,101225,101525,15,3,300,5
00020a9f,101095,101545,9,1,450,5
0001c622,200375,200715,10,0,340,5
00049ad3,200615,200735,2,3,120,5
00027774,200465,200815,10,1,350,5
0001d0b3,200565,200845,12,0,280,5
0001813d,200735,200885,5,0,150,5
0001c026,200815,200985,1,0,170,5
0003d6be,200455,200985,7,2,530,5
0002a6bf,200665,200995,14,1,330,5
0001af17,200695,201025,6,0,330,5
00023437,200545,201035,14,1,490,5
0002a1c3,200805,201075,4,1,270,5
0001019a,200735,201125,2,0,390,5
00034b2f,201035,201195,12,2,160,5
0001fbf7,200735,201225,11,0,490,5
00027f9a,200735,201255,11,1,520,5
000380a7,200855,201255,4,2,400,5
00028f8e,200945,201295,8,1,350,5
0003471e,201115,201315,12,2,200,5
000182bc,200845,201425,10,0,580,5
00016809,201305,201575,2,0,270,5
0001effb,201365,201615,7,0,250,5
00021a7a,201275,201625,9,1,350,5
00042c94,201445,201655,1,3,210,5
0001334b,201205,201695,3,0,490,5
00022917,201425,201705,12,1,280,5
000177af,201315,201735,10,0,420,5
0003b1c6,201425,202015,6,2,590,5
00012f1d,300445,300545,4,0,100,5
0004f7d1,300485,300625,14,3,140,5
0001262b,300445,300685,12,0,240,5
00038644,300465,300725,4,2,260,5
0002859a,300675,300845,12,1,170,5
0003901a,300505,300855,9,2,350,5
0004b3da,300825,300895,12,3,70,5
000293ab,300595,300905,8,1,310,5
0003ff9b,300625,300915,13,2,290,5
0004d3dc,300735,300935,11,3,200,5
0002cab6,300885,301045,2,1,160,5
00011a47,300935,301465,11,0,530,5
00019c4c,185,345,5,0,160,5
00022502,100295,100545,14,1,250,5
00031724,100285,100615,6,2,330,5
00014442,100385,100685,9,0,300,5
0004da71,100485,100685,11,3,200,5
00038f40,100535,100695,3,2,160,5
000271eb,100405,100785,10,1,380,5
0001972f,100685,100795,1,0,110,5
0004f78b,100615,101005,8,3,390,5
0002a831,100765,101045,5,1,280,5
0002d15d,100765,101085,3,1,320,5
00029a90,101095,101165,1,1,70,5
00029c1d,101015,101205,2,1,190,5
0003d9eb,101095,101215,3,2,120,5
0004b1bb,100945,101225,4,3,280,5
0001daf3,100835,101285,9,0,450,5
0002cf0f,100895,101345,9,1,450,5
0004183c,101175,101345,3,3,170,5
0003de7d,100945,101375,11,2,430,5
00023fcd,101155,101445,13,1,290,5
0004bb48,101225,101525,15,3,300,5
00020a9f,101095,101545,9,1,450,5
0001c622,200375,200715,10,0,340,5
00049ad3,200615,200735,2,3,120,5
00027774,200465,200815,10,1,350,5
0001d0b3,200565,200845,12,0,280,5
0001813d,200735,200885,5,0,150,5
0001c026,200815,200985,1,0,170,5
0003d6be,200455,200985,7,2,530,5
0002a6bf,200665,200995,14,1,330,5
0001af17,200695,201025,6,0,330,5
00023437,200545,201035,14,1,490,5
0002a1c3,200805,201075,4,1,270,5
0001019a,200735,201125,2,0,390,5
00034b2f,201035,201195,12,2,160,5
0001fbf7,200735,201225,11,0,490,5
00027f9a,200735,201255,11,1,520,5
000380a7,200855,201255,4,2,400,5
00028f8e,200945,201295,8,1,350,5
0003471e,201115,201315,12,2,200,5
000182bc,200845,201425,10,0,580,5
00016809,201305,201575,2,0,270,5
0001effb,201365,201615,7,0,250,5
00021a7a,201275,201625,9,1,350,5
00042c94,201445,201655,1,3,210,5
0001334b,201205,201695,3,0,490,5
00022917,201425,201705,12,1,280,5
000177af,201315,201735,10,0,420,5
0003b1c6,201425,202015,6,2,590,5
00012f1d,300445,300545,4,0,100,5
0004f7d1,300485,300625,14,3,140,5
0001262b,300445,300685,12,0,240,5
00038644,300465,300725,4,2,260,5
0002859a,300675,300845,12,1,170,5
0003901a,300505,300855,9,2,350,5
0004b3da,300825,300895,12,3,70,5
000293ab,300595,300905,8,1,310,5
0003ff9b,300625,300915,13,2,290,5
0004d3dc,300735,300935,11,3,200,5
0002cab6,300885,301045,2,1,160,5
00011a47,300935,301465,11,0,530,5
0002e16f,400535,400655,0,1,120,5
00048956,400615,400835,1,3,220,5
00011a78,400685,400875,3,0,190,5
00020474,400725,400895,13,1,170,5
00016965,400595,400915,10,0,320,5
0003de2f,400605,401005,15,2,400,5
000184a5,400875,401015,5,0,140,5
00031420,400785,401045,13,2,260,5
00026945,401065,401135,1,1,70,5
000210b8,401065,401215,0,1,150,5
0003a013,400965,401245,10,2,280,5
0002aa60,401235,401355,2,1,120,5
00043259,401035,401365,5,3,330,5
0001dc9f,401355,401445,4,0,90,5
0002714a,401145,401475,7,1,330,5
00021964,135,335,13,1,200,15
00021964,135,335,13,1,200,15
000229c8,100265,100345,2,1,80,15
00031ded,100325,100425,2,2,100,15
00017fb6,100315,100475,5,0,160,15
0004bddf,100415,100655,15,3,240,15
0003471a,100595,100695,2,2,100,15
00020f45,100505,100785,14,1,280,15
0004c38b,100585,100825,10,3,240,15
0003ecd9,100595,100945,8,2,350,15
00018a7b,101005,101055,4,0,50,15
00028cbc,100715,101055,11,1,340,15
00033005,100765,101065,9,2,300,15
00032a04,100825,101225,14,2,400,15
0004013f,100655,101305,8,3,650,15
0003ba50,100915,101325,15,2,410,15
0004da30,101065,101345,0,3,280,15
0002b924,101225,101365,4,1,140,15
00033c4e,100765,101365,7,2,600,15
00011d12,101255,101455,6,0,200,15
000441e4,101155,101495,1,3,340,15
0004daba,101365,101595,2,3,230,15
0002cc16,101225,101635,8,1,410,15
0001aa7c,101125,101665,10,0,540,15
00049ce6,101565,101715,13,3,150,15
000388b5,101375,101745,9,2,370,15
0004a3de,101415,101815,15,3,400,15
000471a8,101275,101915,6,3,640,15
00028642,101595,101925,8,1,330,15
0001da7a,101665,101945,1,0,280,15
0001e0fe,101505,102205,15,0,700,15
00021964,135,335,13,1,200,15
000229c8,100265,100345,2,1,80,15
00031ded,100325,100425,2,2,100,15
00017fb6,100315,100475,5,0,160,15
0004bddf,100415,100655,15,3,240,15
0003471a,100595,100695,2,2,100,15
00020f45,100505,100785,14,1,280,15
0004c38b,100585,100825,10,3,240,15
0003ecd9,100595,100945,8,2,350,15
00018a7b,101005,101055,4,0,50,15
00028cbc,100715,101055,11,1,340,15
00033005,100765,101065,9,2,300,15
00032a04,100825,101225,14,2,400,15
0004013f,100655,101305,8,3,650,15
0003ba50,100915,101325,15,2,410,15
0004da30,101065,101345,0,3,280,15
0002b924,101225,101365,4,1,140,15
00033c4e,100765,101365,7,2,600,15
00011d12,101255,101455,6,0,200,15
000441e4,101155,101495,1,3,340,15
0004daba,101365,101595,2,3,230,15
0002cc16,101225,101635,8,1,410,15
0001aa7c,101125,101665,10,0,540,15
00049ce6,101565,101715,13,3,150,15
000388b5,101375,101745,9,2,370,15
0004a3de,101415,101815,15,3,400,15
000471a8,101275,101915,6,3,640,15
00028642,101595,101925,8,1,330,15
0001da7a,101665,101945,1,0,280,15
0001e0fe,101505,102205,15,0,700,15
0004be3b,200385,200425,3,3,40,15
00021b0e,200335,200655,15,1,320,15
0002167b,200665,200735,1,1,70,15
00047ccc,200475,200735,15,3,260,15
000323e1,200745,200875,12,2,130,15
0003050b,200535,200915,15,2,380,15
00016171,200735,200995,8,0,260,15
00039680,200625,200995,14,2,370,15
00021964,135,335,13,1,200,15
000229c8,100265,100345,2,1,80,15
00031ded,100325,100425,2,2,100,15
00017fb6,100315,100475,5,0,160,15
0004bddf,100415,100655,15,3,240,15
0003471a,100595,100695,2,2,100,15
00020f45,100505,100785,14,1,280,15
0004c38b,100585,100825,10,3,240,15
0003ecd9,100595,100945,8,2,350,15
00018a7b,101005,101055,4,0,50,15
00028cbc,100715,101055,11,1,340,15
00033005,100765,101065,9,2,300,15
00032a04,100825,101225,14,2,400,15
0004013f,100655,101305,8,3,650,15
0003ba50,100915,101325,15,2,410,15
0004da30,101065,101345,0,3,280,15
0002b924,101225,101365,4,1,140,15
00033c4e,100765,101365,7,2,600,15
00011d12,101255,101455,6,0,200,15
000441e4,101155,101495,1,3,340,15
0004daba,101365,101595,2,3,230,15
0002cc16,101225,101635,8,1,410,15
0001aa7c,101125,101665,10,0,540,15
00049ce6,101565,101715,13,3,150,15
000388b5,101375,101745,9,2,370,15
0004a3de,101415,101815,15,3,400,15
000471a8,101275,101915,6,3,640,15
00028642,101595,101925,8,1,330,15
0001da7a,101665,101945,1,0,280,15
0001e0fe,101505,102205,15,0,700,15
0004be3b,200385,200425,3,3,40,15
00021b0e,200335,200655,15,1,320,15
0002167b,200665,200735,1,1,70,15
00047ccc,200475,200735,15,3,260,15
000323e1,200745,200875,12,2,130,15
0003050b,200535,200915,15,2,380,15
00016171,200735,200995,8,0,260,15
00039680,200625,200995,14,2,370,15
0002349f,300485,300565,2,1,80,15
0001ca76,300635,300815,5,0,180,15
000241fa,300485,300835,11,1,350,15
0001bfc9,300605,300895,2,0,290,15
0004e6f0,300725,300895,1,3,170,15
00020d40,300575,300935,5,1,360,15
000137c3,300735,300975,13,0,240,15
000306fa,300485,301085,11,2,600,15
0003bb6e,300975,301125,1,2,150,15
0001e901,300665,301145,10,0,480,15
0001326d,300845,301265,12,0,420,15
00039bc1,301055,301265,4,2,210,15
0004aa39,300765,301265,10,3,500,15
0001ecd3,300915,301345,12,0,430,15
00035bb1,300675,301365,9,2,690,15
0001edb6,301135,301385,8,0,250,15
000146fb,301215,301465,2,0,250,15
00021964,135,335,13,1,200,15
000229c8,100265,100345,2,1,80,15
00031ded,100325,100425,2,2,100,15
00017fb6,100315,100475,5,0,160,15
0004bddf,100415,100655,15,3,240,15
0003471a,100595,100695,2,2,100,15
00020f45,100505,100785,14,1,280,15
0004c38b,100585,100825,10,3,240,15
0003ecd9,100595,100945,8,2,350,15
00018a7b,101005,101055,4,0,50,15
00028cbc,100715,101055,11,1,340,15
00033005,100765,101065,9,2,300,15
00032a04,100825,101225,14,2,400,15
0004013f,100655,101305,8,3,650,15
0003ba50,100915,101325,15,2,410,15
0004da30,101065,101345,0,3,280,15
0002b924,101225,101365,4,1,140,15
00033c4e,100765,101365,7,2,600,15
00011d12,101255,101455,6,0,200,15
000441e4,101155,101495,1,3,340,15
0004daba,101365,101595,2,3,230,15
0002cc16,101225,101635,8,1,410,15
0001aa7c,101125,101665,10,0,540,15
00049ce6,101565,101715,13,3,150,15
000388b5,101375,101745,9,2,370,15
0004a3de,101415,101815,15,3,400,15
000471a8,101275,101915,6,3,640,15
00028642,101595,101925,8,1,330,15
0001da7a,101665,101945,1,0,280,15
0001e0fe,101505,102205,15,0,700,15
0004be3b,200385,200425,3,3,40,15
00021b0e,200335,200655,15,1,320,15
0002167b,200665,200735,1,1,70,15
00047ccc,200475,200735,15,3,260,15
000323e1,200745,200875,12,2,130,15
0003050b,200535,200915,15,2,380,15
00016171,200735,200995,8,0,260,15
00039680,200625,200995,14,2,370,15
0002349f,300485,300565,2,1,80,15
0001ca76,300635,300815,5,0,180,15
000241fa,300485,300835,11,1,350,15
0001bfc9,300605,300895,2,0,290,15
0004e6f0,300725,300895,1,3,170,15
00020d40,300575,300935,5,1,360,15
000137c3,300735,300975,13,0,240,15
000306fa,300485,301085,11,2,600,15
0003bb6e,300975,301125,1,2,150,15
0001e901,300665,301145,10,0,480,15
0001326d,300845,301265,12,0,420,15
00039bc1,301055,301265,4,2,210,15
0004aa39,300765,301265,10,3,500,15
0001ecd3,300915,301345,12,0,430,15
00035bb1,300675,301365,9,2,690,15
0001edb6,301135,301385,8,0,250,15
000146fb,301215,301465,2,0,250,15
00046fbf,400545,400605,12,3,60,15
00035c31,400595,400765,14,2,170,15
0004f14d,125,325,1,3,200,9
0004f14d,125,325,1,3,200,9
00015b26,100285,100405,2,0,120,9
00022620,100235,100525,15,1,290,9
000454f8,100415,100595,14,3,180,9
00049aae,100335,100685,8,3,350,9
000304b3,100625,100695,2,2,70,9
00036960,100495,100755,14,2,260,9
0004366e,100585,100825,15,3,240,9
000334c5,100695,100885,5,2,190,9
00027bff,100515,100895,13,1,380,9
0004e510,100905,101005,2,3,100,9
0002d51e,100535,101015,9,1,480,9
00012eac,100875,101025,1,0,150,9
0002272d,100535,101115,13,1,580,9
00024767,100985,101175,2,1,190,9
00030cc7,100835,101175,15,2,340,9
00026425,100985,101215,6,1,230,9
00012d5f,100785,101255,15,0,470,9
000304b2,101045,101285,0,2,240,9
00016bf3,101295,101365,0,0,70,9
000492b9,101325,101545,11,3,220,9
00030f57,101245,101565,14,2,320,9
00038e44,101115,101605,7,2,490,9
000306e8,101395,101735,14,2,340,9
00015534,101155,101745,15,0,590,9
00038a81,101535,101865,14,2,330,9
000343aa,101605,101905,9,2,300,9
0003c056,101485,101965,8,2,480,9
000213b8,101645,102025,14,1,380,9
0004f14d,125,325,1,3,200,9
00015b26,100285,100405,2,0,120,9
00022620,100235,100525,15,1,290,9
000454f8,100415,100595,14,3,180,9
00049aae,100335,100685,8,3,350,9
000304b3,100625,100695,2,2,70,9
00036960,100495,100755,14,2,260,9
0004366e,100585,100825,15,3,240,9
000334c5,100695,100885,5,2,190,9
00027bff,100515,100895,13,1,380,9
0004e510,100905,101005,2,3,100,9
0002d51e,100535,101015,9,1,480,9
00012eac,100875,101025,1,0,150,9
0002272d,100535,101115,13,1,580,9
00024767,100985,101175,2,1,190,9
00030cc7,100835,101175,15,2,340,9
00026425,100985,101215,6,1,230,9
00012d5f,100785,101255,15,0,470,9
000304b2,101045,101285,0,2,240,9
00016bf3,101295,101365,0,0,70,9
000492b9,101325,101545,11,3,220,9
00030f57,101245,101565,14,2,320,9
00038e44,101115,101605,7,2,490,9
000306e8,101395,101735,14,2,340,9
00015534,101155,101745,15,0,590,9
00038a81,101535,101865,14,2,330,9
000343aa,101605,101905,9,2,300,9
0003c056,101485,101965,8,2,480,9
000213b8,101645,102025,14,1,380,9
0001f6f6,200355,200515,5,0,160,9
00029f57,200365,200585,9,1,220,9
00044321,200375,200635,11,3,260,9
00027d64,200505,200665,2,1,160,9
00032031,200655,200755,2,2,100,9
0003b2bb,200445,200835,9,2,390,9
000343b2,200585,200915,7,2,330,9
00031e3a,200585,201065,11,2,480,9
00026681,200675,201095,14,1,420,9
0003100d,200725,201165,9,2,440,9
0004397b,200855,201275,5,3,420,9
0001ee07,200785,201285,9,0,500,9
0002da60,200785,201295,11,1,510,9
0002054d,200855,201335,14,1,480,9
0004f14d,125,325,1,3,200,9
00015b26,100285,100405,2,0,120,9
00022620,100235,100525,15,1,290,9
000454f8,100415,100595,14,3,180,9
00049aae,100335,100685,8,3,350,9
000304b3,100625,100695,2,2,70,9
00036960,100495,100755,14,2,260,9
0004366e,100585,100825,15,3,240,9
000334c5,100695,100885,5,2,190,9
00027bff,100515,100895,13,1,380,9
0004e510,100905,101005,2,3,100,9
0002d51e,100535,101015,9,1,480,9
00012eac,100875,101025,1,0,150,9
0002272d,100535,101115,13,1,580,9
00024767,100985,101175,2,1,190,9
00030cc7,100835,101175,15,2,340,9
00026425,100985,101215,6,1,230,9
00012d5f,100785,101255,15,0,470,9
000304b2,101045,101285,0,2,240,9
00016bf3,101295,101365,0,0,70,9
000492b9,101325,101545,11,3,220,9
00030f57,101245,101565,14,2,320,9
00038e44,101115,101605,7,2,490,9
000306e8,101395,101735,14,2,340,9
00015534,101155,101745,15,0,590,9
00038a81,101535,101865,14,2,330,9
000343aa,101605,101905,9,2,300,9
0003c056,101485,101965,8,2,480,9
000213b8,101645,102025,14,1,380,9
0001f6f6,200355,200515,5,0,160,9
00029f57,200365,200585,9,1,220,9
00044321,200375,200635,11,3,260,9
00027d64,200505,200665,2,1,160,9
00032031,200655,200755,2,2,100,9
0003b2bb,200445,200835,9,2,390,9
000343b2,200585,200915,7,2,330,9
00031e3a,200585,201065,11,2,480,9
00026681,200675,201095,14,1,420,9
0003100d,200725,201165,9,2,440,9
0004397b,200855,201275,5,3,420,9
0001ee07,200785,201285,9,0,500,9
0002da60,200785,201295,11,1,510,9
0002054d,200855,201335,14,1,480,9
0003ba5e,300415,300775,8,2,360,9
0004e7a7,300715,300835,3,3,120,9
0001eb82,300605,300855,3,0,250,9
0003671b,300475,300875,6,2,400,9
00029421,300545,300905,11,1,360,9
0003f01e,300765,300915,1,2,150,9
0004a12a,300645,300965,14,3,320,9
0003c22c,300695,301035,7,2,340,9
00043590,300715,301085,11,3,370,9
0001a803,300835,301095,3,0,260,9
00048cf6,301015,301165,12,3,150,9
00027eb1,300955,301185,12,1,230,9
00025d6d,300905,301225,10,1,320,9
0003728f,300905,301315,8,2,410,9
000153b4,301275,301345,1,0,70,9
00032027,301115,301355,4,2,240,9
000431cc,301285,301435,2,3,150,9
00033523,301145,301475,0,2,330,9
0001f6e7,301165,301485,2,0,320,9
0002ae87,301465,301565,2,1,100,9
0003b680,301125,301595,5,2,470,9
0002ad3e,301095,301625,7,1,530,9
0003fcbe,301245,301765,5,2,520,9
0003fcbe,301245,301885,5,2,640,9
0001eafb,301645,301955,3,0,310,9
0004717b,301725,302025,15,3,300,9
00038b08,301265,302035,7,2,770,9
00040fad,301555,302155,7,3,600,9
0004cf28,301465,302195,6,3,730,9
00049da4,301325,302325,7,3,1000,9
0004f14d,125,325,1,3,200,9
00015b26,100285,100405,2,0,120,9
00022620,100235,100525,15,1,290,9
000454f8,100415,100595,14,3,180,9
00049aae,100335,100685,8,3,350,9
000304b3,100625,100695,2,2,70,9
00036960,100495,100755,14,2,260,9
0004366e,100585,100825,15,3,240,9
000334c5,100695,100885,5,2,190,9
00027bff,100515,100895,13,1,380,9
0004e510,100905,101005,2,3,100,9
0002d51e,100535,101015,9,1,480,9
00012eac,100875,101025,1,0,150,9
0002272d,100535,101115,13,1,580,9
00024767,100985,101175,2,1,190,9
00030cc7,100835,101175,15,2,340,9
00026425,100985,101215,6,1,230,9
00012d5f,100785,101255,15,0,470,9
000304b2,101045,101285,0,2,240,9
00016bf3,101295,101365,0,0,70,9
000492b9,101325,101545,11,3,220,9
00030f57,101245,101565,14,2,320,9
00038e44,101115,101605,7,2,490,9
000306e8,101395,101735,14,2,340,9
00015534,101155,101745,15,0,590,9
00038a81,101535,101865,14,2,330,9
000343aa,101605,101905,9,2,300,9
0003c056,101485,101965,8,2,480,9
000213b8,101645,102025,14,1,380,9
0001f6f6,200355,200515,5,0,160,9
00029f57,200365,200585,9,1,220,9
00044321,200375,200635,11,3,260,9
00027d64,200505,200665,2,1,160,9
00032031,200655,200755,2,2,100,9
0003b2bb,200445,200835,9,2,390,9
000343b2,200585,200915,7,2,330,9
00031e3a,200585,201065,11,2,480,9
00026681,200675,201095,14,1,420,9
0003100d,200725,201165,9,2,440,9
0004397b,200855,201275,5,3,420,9
0001ee07,200785,201285,9,0,500,9
0002da60,200785,201295,11,1,510,9
0002054d,200855,201335,14,1,480,9
0003ba5e,300415,300775,8,2,360,9
0004e7a7,300715,300835,3,3,120,9
0001eb82,300605,300855,3,0,250,9
0003671b,300475,300875,6,2,400,9
00029421,300545,300905,11,1,360,9
0003f01e,300765,300915,1,2,150,9
0004a12a,300645,300965,14,3,320,9
0003c22c,300695,301035,7,2,340,9
00043590,300715,301085,11,3,370,9
0001a803,300835,301095,3,0,260,9
00048cf6,301015,301165,12,3,150,9
00027eb1,300955,301185,12,1,230,9
00025d6d,300905,301225,10,1,320,9
0003728f,300905,301315,8,2,410,9
000153b4,301275,301345,1,0,70,9
00032027,301115,301355,4,2,240,9
000431cc,301285,301435,2,3,150,9
00033523,301145,301475,0,2,330,9
0001f6e7,301165,301485,2,0,320,9
0002ae87,301465,301565,2,1,100,9
0003b680,301125,301595,5,2,470,9
0002ad3e,301095,301625,7,1,530,9
0003fcbe,301245,301765,5,2,520,9
0003fcbe,301245,301885,5,2,640,9
0001eafb,301645,301955,3,0,310,9
0004717b,301725,302025,15,3,300,9
00038b08,301265,302035,7,2,770,9
00040fad,301555,302155,7,3,600,9
0004cf28,301465,302195,6,3,730,9
00049da4,301325,302325,7,3,1000,9
00018fb8,400575,400755,12,0,180,9
0002a356,400585,400935,7,1,350,9
0001bd9f,400605,400945,3,0,340,9
0003208a,400635,400945,9,2,310,9
0002855b,400605,400995,14,1,390,9
000411d6,400885,401035,2,3,150,9
0003a3cc,400725,401145,7,2,420,9
00044db2,400935,401155,15,3,220,9
00010879,400805,401175,9,0,370,9
000303b6,400885,401205,15,2,320,9
0003554d,400995,401245,4,2,250,9
000145a9,400905,401275,13,0,370,9
00026aca,401215,401325,2,1,110,9
000412fe,401035,401325,14,3,290,9
000423dc,401155,401475,0,3,320,9
0003cc32,400875,401575,7,2,700,9
00016a13,401085,401605,14,0,520,9
00034418,401265,401655,15,2,390,9
000161fd,125,225,4,0,100,6
000161fd,125,225,4,0,100,6
0004d47d,100265,100305,3,3,40,6
0004ea09,100215,100375,14,3,160,6
0003d618,100215,100415,0,2,200,6
00013792,100375,100445,1,0,70,6
0001ec7d,100355,100595,3,0,240,6
00025a33,100295,100605,11,1,310,6
000161fd,125,225,4,0,100,6
0004d47d,100265,100305,3,3,40,6
0004ea09,100215,100375,14,3,160,6
0003d618,100215,100415,0,2,200,6
00013792,100375,100445,1,0,70,6
0001ec7d,100355,100595,3,0,240,6
00025a33,100295,100605,11,1,310,6
0001de1b,200325,200565,11,0,240,6
00012bc1,200635,200695,4,0,60,6
00027cb0,200395,200695,9,1,300,6
0004f144,200465,200715,10,3,250,6
0001de1b,200325,200755,11,0,430,6
0003414d,200515,200845,8,2,330,6
0001de1b,200325,200925,11,0,600,6
0001fa5d,200695,200965,7,0,270,6
0003f58e,200605,201005,10,2,400,6
0003fac0,200905,201045,1,2,140,6
00042b47,200755,201085,15,3,330,6
00010195,200905,201145,1,0,240,6
000425fa,201065,201145,3,3,80,6
0003b370,200795,201185,9,2,390,6
0002e448,200795,201195,5,1,400,6
00011011,200795,201285,8,0,490,6
0001efb6,200725,201365,10,0,640,6
000498d1,200875,201395,5,3,520,6
000143fb,201355,201445,0,0,90,6
0001eaea,200975,201485,13,0,510,6
00034d97,201415,201485,3,2,70,6
00047053,201215,201525,10,3,310,6
0003f22f,201145,201545,9,2,400,6
000153ee,201505,201595,0,0,90,6
00039a1c,201305,201765,9,2,460,6
0002fa8f,201705,201815,4,1,110,6
0002d201,201585,202015,8,1,430,6
00041f1f,201615,202095,9,3,480,6
000161fd,125,225,4,0,100,6
0004d47d,100265,100305,3,3,40,6
0004ea09,100215,100375,14,3,160,6
0003d618,100215,100415,0,2,200,6
00013792,100375,100445,1,0,70,6
0001ec7d,100355,100595,3,0,240,6
00025a33,100295,100605,11,1,310,6
0001de1b,200325,200565,11,0,240,6
00012bc1,200635,200695,4,0,60,6
00027cb0,200395,200695,9,1,300,6
0004f144,200465,200715,10,3,250,6
0001de1b,200325,200755,11,0,430,6
0003414d,200515,200845,8,2,330,6
0001de1b,200325,200925,11,0,600,6
0001fa5d,200695,200965,7,0,270,6
0003f58e,200605,201005,10,2,400,6
0003fac0,200905,201045,1,2,140,6
00042b47,200755,201085,15,3,330,6
00010195,200905,201145,1,0,240,6
000425fa,201065,201145,3,3,80,6
0003b370,200795,201185,9,2,390,6
0002e448,200795,201195,5,1,400,6
00011011,200795,201285,8,0,490,6
0001efb6,200725,201365,10,0,640,6
000498d1,200875,201395,5,3,520,6
000143fb,201355,201445,0,0,90,6
0001eaea,200975,201485,13,0,510,6
00034d97,201415,201485,3,2,70,6
00047053,201215,201525,10,3,310,6
0003f22f,201145,201545,9,2,400,6
000153ee,201505,201595,0,0,90,6
00039a1c,201305,201765,9,2,460,6
0002fa8f,201705,201815,4,1,110,6
0002d201,201585,202015,8,1,430,6
00041f1f,201615,202095,9,3,480,6
00010cc2,300475,300515,0,0,40,6
000161fd,125,225,4,0,100,6
0004d47d,100265,100305,3,3,40,6
0004ea09,100215,100375,14,3,160,6
0003d618,100215,100415,0,2,200,6
00013792,100375,100445,1,0,70,6
0001ec7d,100355,100595,3,0,240,6
00025a33,100295,100605,11,1,310,6
0001de1b,200325,200565,11,0,240,6
00012bc1,200635,200695,4,0,60,6
00027cb0,200395,200695,9,1,300,6
0004f144,200465,200715,10,3,250,6
0001de1b,200325,200755,11,0,430,6
0003414d,200515,200845,8,2,330,6
0001de1b,200325,200925,11,0,600,6
0001fa5d,200695,200965,7,0,270,6
0003f58e,200605,201005,10,2,400,6
0003fac0,200905,201045,1,2,140,6
00042b47,200755,201085,15,3,330,6
00010195,200905,201145,1,0,240,6
000425fa,201065,201145,3,3,80,6
0003b370,200795,201185,9,2,390,6
0002e448,200795,201195,5,1,400,6
00011011,200795,201285,8,0,490,6
0001efb6,200725,201365,10,0,640,6
000498d1,200875,201395,5,3,520,6
000143fb,201355,201445,0,0,90,6
0001eaea,200975,201485,13,0,510,6
00034d97,201415,201485,3,2,70,6
00047053,201215,201525,10,3,310,6
0003f22f,201145,201545,9,2,400,6
000153ee,201505,201595,0,0,90,6
00039a1c,201305,201765,9,2,460,6
0002fa8f,201705,201815,4,1,110,6
0002d201,201585,202015,8,1,430,6
00041f1f,201615,202095,9,3,480,6
00010cc2,300475,300515,0,0,40,6
00018c1b,300396,300625,12,0,229,6
00022fdf,300565,300795,9,1,230,6
000149f2,300765,300925,0,0,160,6
00043632,300735,300985,0,3,250,6
0002bed3,300645,300995,11,1,350,6
0003fa4f,300835,301045,3,2,210,6
0003aa88,400525,400685,13,2,160,6
0001c600,400685,400975,3,0,290,6
0002e2ee,400815,401045,4,1,230,6
0001770c,400735,401095,12,0,360,6
0002c68b,400805,401105,15,1,300,6
0004dbf9,400945,401115,13,3,170,6
0002c8fc,400805,401165,6,1,360,6
00040c35,400595,401215,6,3,620,6
00022072,400955,401265,11,1,310,6
00022072,400955,401345,11,1,390,6
00024c26,400965,401465,13,1,500,6
0004a1c9,401195,401465,0,3,270,6
000244d5,401445,401565,2,1,120,6
0003df74,401105,401575,6,2,470,6
00026bea,400995,401605,7,1,610,6
0002a020,401055,401645,7,1,590,6
0002f633,401295,401705,15,1,410,6
0002f1a7,401515,401765,4,1,250,6
0003de20,401385,401875,11,2,490,6
00028505,401275,401885,7,1,610,6
0001f545,401505,401895,13,0,390,6
0004de85,401555,402065,5,3,510,6
0004cf98,115,635,7,3,520,9
0004cf98,115,635,7,3,520,9
000333cd,100295,100395,12,2,100,9
000158bf,100355,100435,1,0,80,9
00018c35,100415,100495,4,0,80,9
0003cca3,100355,100545,1,2,190,9
000303ec,100205,100655,7,2,450,9
0002c0ab,100595,100785,2,1,190,9
0004109f,100765,100845,3,3,80,9
000123ca,100725,100875,5,0,150,9
0003dfc8,100555,100895,9,2,340,9
0004c115,100545,100905,10,3,360,9
00047150,100455,100985,7,3,530,9
0003fb30,100665,100995,0,2,330,9
0004429c,100825,101135,15,3,310,9
00032cbd,100645,101155,7,2,510,9
0002baa2,101005,101165,3,1,160,9
0003126e,100815,101195,1,2,380,9
00022479,100815,101245,11,1,430,9
0003e03c,100705,101315,0,2,610,9
00029c8c,100915,101345,10,1,430,9
0004cf98,115,635,7,3,520,9
000333cd,100295,100395,12,2,100,9
000158bf,100355,100435,1,0,80,9
00018c35,100415,100495,4,0,80,9
0003cca3,100355,100545,1,2,190,9
000303ec,100205,100655,7,2,450,9
0002c0ab,100595,100785,2,1,190,9
0004109f,100765,100845,3,3,80,9
000123ca,100725,100875,5,0,150,9
0003dfc8,100555,100895,9,2,340,9
0004c115,100545,100905,10,3,360,9
00047150,100455,100985,7,3,530,9
0003fb30,100665,100995,0,2,330,9
0004429c,100825,101135,15,3,310,9
00032cbd,100645,101155,7,2,510,9
0002baa2,101005,101165,3,1,160,9
0003126e,100815,101195,1,2,380,9
00022479,100815,101245,11,1,430,9
0003e03c,100705,101315,0,2,610,9
00029c8c,100915,101345,10,1,430,9
0003a972,200335,200435,12,2,100,9
00020986,200405,200445,1,1,40,9
00022fb0,200405,200625,6,1,220,9
0001ad7c,200555,200655,4,0,100,9
0004133e,200625,200725,12,3,100,9
00015c2b,200525,200775,7,0,250,9
00036c52,200685,200775,2,2,90,9
00026999,200385,200785,9,1,400,9
00033fd8,200455,200835,6,2,380,9
0003d10d,200545,200935,9,2,390,9
0002a71b,200705,201075,9,1,370,9
0002ce73,200845,201185,11,1,340,9
00012558,200805,201225,9,0,420,9
000333f6,200875,201285,11,2,410,9
00045668,200745,201335,7,3,590,9
0004cf98,115,635,7,3,520,9
000333cd,100295,100395,12,2,100,9
000158bf,100355,100435,1,0,80,9
00018c35,100415,100495,4,0,80,9
0003cca3,100355,100545,1,2,190,9
000303ec,100205,100655,7,2,450,9
0002c0ab,100595,100785,2,1,190,9
0004109f,100765,100845,3,3,80,9
000123ca,100725,100875,5,0,150,9
0003dfc8,100555,100895,9,2,340,9
0004c115,100545,100905,10,3,360,9
00047150,100455,100985,7,3,530,9
0003fb30,100665,100995,0,2,330,9
0004429c,100825,101135,15,3,310,9
00032cbd,100645,101155,7,2,510,9
0002baa2,101005,101165,3,1,160,9
0003126e,100815,101195,1,2,380,9
00022479,100815,101245,11,1,430,9
0003e03c,100705,101315,0,2,610,9
00029c8c,100915,101345,10,1,430,9
0003a972,200335,200435,12,2,100,9
00020986,200405,200445,1,1,40,9
00022fb0,200405,200625,6,1,220,9
0001ad7c,200555,200655,4,0,100,9
0004133e,200625,200725,12,3,100,9
00015c2b,200525,200775,7,0,250,9
00036c52,200685,200775,2,2,90,9
00026999,200385,200785,9,1,400,9
00033fd8,200455,200835,6,2,380,9
0003d10d,200545,200935,9,2,390,9
0002a71b,200705,201075,9,1,370,9
0002ce73,200845,201185,11,1,340,9
00012558,200805,201225,9,0,420,9
000333f6,200875,201285,11,2,410,9
00045668,200745,201335,7,3,590,9
000396c9,300535,300655,1,2,120,9
0001df13,300555,300795,13,0,240,9
00046b23,300645,300805,2,3,160,9
00032fa3,300655,300845,13,2,190,9
0002b256,300455,300875,15,1,420,9
0003e587,300735,300905,2,2,170,9
00023763,300465,300915,11,1,450,9
00042452,300635,300935,5,3,300,9
0003d8a2,300825,300945,3,2,120,9
0002c3df,300875,300975,4,1,100,9
0004cff0,300735,301045,10,3,310,9
0002029c,300625,301145,11,1,520,9
0004702b,301035,301205,1,3,170,9
0001afe6,300955,301325,7,0,370,9
00040395,300955,301375,7,3,420,9
00043e08,301315,301435,3,3,120,9
0004e747,301315,301495,13,3,180,9
00034d1c,301105,301505,14,2,400,9
0002ea88,301185,301535,8,1,350,9
00033dbe,301295,301625,14,2,330,9
0004002e,301185,301695,5,3,510,9
0003f535,301215,301705,15,2,490,9
00025912,301395,301765,11,1,370,9
000242d0,301425,301905,10,1,480,9
00042330,155,355,1,3,200,2
00042330,155,355,1,3,200,2
0002e3ed,100345,100385,1,1,40,2
000309c2,100265,100525,10,2,260,2
0003883b,100465,100595,0,2,130,2
00014ba5,100435,100715,14,0,280,2
0003df3f,100705,100775,2,2,70,2
0001d627,100365,100815,15,0,450,2
00018490,100465,100915,10,0,450,2
0003b44b,100705,100945,0,2,240,2
00014b1d,100495,100955,11,0,460,2
00037ceb,100615,101025,15,2,410,2
00040ee3,100555,101025,10,3,470,2
000195e6,100745,101085,7,0,340,2
0004bd07,100695,101145,15,3,450,2
000327fd,100975,101175,13,2,200,2
0002251f,100815,101195,11,1,380,2
0003f924,100865,101255,10,2,390,2
0003af51,100905,101295,6,2,390,2
00021823,100995,101315,14,1,320,2
0002daec,101085,101415,3,1,330,2
00036582,101125,101415,4,2,290,2
00025861,101365,101495,4,1,130,2
0001dbd4,100825,101615,15,0,790,2
0001341c,101285,101655,7,0,370,2
00018962,101205,101715,11,0,510,2
00023e94,101415,101725,11,1,310,2
0003e459,101335,101725,14,2,390,2
00015c49,101335,101755,9,0,420,2
00040b07,101415,101755,0,3,340,2
00014aed,101495,101855,7,0,360,2
0001c6f1,101285,101965,15,0,680,2
00042330,155,355,1,3,200,2
0002e3ed,100345,100385,1,1,40,2
000309c2,100265,100525,10,2,260,2
0003883b,100465,100595,0,2,130,2
00014ba5,100435,100715,14,0,280,2
0003df3f,100705,100775,2,2,70,2
0001d627,100365,100815,15,0,450,2
00018490,100465,100915,10,0,450,2
0003b44b,100705,100945,0,2,240,2
00014b1d,100495,100955,11,0,460,2
00037ceb,100615,101025,15,2,410,2
00040ee3,100555,101025,10,3,470,2
000195e6,100745,101085,7,0,340,2
0004bd07,100695,101145,15,3,450,2
000327fd,100975,101175,13,2,200,2
0002251f,100815,101195,11,1,380,2
0003f924,100865,101255,10,2,390,2
0003af51,100905,101295,6,2,390,2
00021823,100995,101315,14,1,320,2
0002daec,101085,101415,3,1,330,2
00036582,101125,101415,4,2,290,2
00025861,101365,101495,4,1,130,2
0001dbd4,100825,101615,15,0,790,2
0001341c,101285,101655,7,0,370,2
00018962,101205,101715,11,0,510,2
00023e94,101415,101725,11,1,310,2
0003e459,101335,101725,14,2,390,2
00015c49,101335,101755,9,0,420,2
00040b07,101415,101755,0,3,340,2
00014aed,101495,101855,7,0,360,2
0001c6f1,101285,101965,15,0,680,2
0003444e,200375,200495,1,2,120,2
00025d32,200615,200715,1,1,100,2
00042fa8,200555,200795,0,3,240,2
0001afcc,200505,200845,14,0,340,2
00042fa8,200555,200995,0,3,440,2
00037090,200945,201045,2,2,100,2
00049bd6,200705,201095,4,3,390,2
0003f197,200565,201125,7,2,560,2
00012896,200785,201205,11,0,420,2
00040493,200875,201235,0,3,360,2
00021917,201025,201325,6,1,300,2
000425c8,200965,201345,7,3,380,2
0001c7bc,201135,201385,3,0,250,2
0003e985,201185,201415,0,2,230,2
00037d7d,201045,201595,7,2,550,2
00010bad,201225,201625,11,0,400,2
00035a5f,201265,201635,4,2,370,2
00045540,201225,201725,6,3,500,2
00041af7,201365,201765,0,3,400,2
0001cd0a,201565,201785,1,0,220,2
00014ded,201335,201865,15,0,530,2
00040278,201475,201925,7,3,450,2
0004ccb4,201385,201965,7,3,580,2
00015d13,201655,202075,14,0,420,2
00042330,155,355,1,3,200,2
0002e3ed,100345,100385,1,1,40,2
000309c2,100265,100525,10,2,260,2
0003883b,100465,100595,0,2,130,2
00014ba5,100435,100715,14,0,280,2
0003df3f,100705,100775,2,2,70,2
0001d627,100365,100815,15,0,450,2
00018490,100465,100915,10,0,450,2
0003b44b,100705,100945,0,2,240,2
00014b1d,100495,100955,11,0,460,2
00037ceb,100615,101025,15,2,410,2
00040ee3,100555,101025,10,3,470,2
000195e6,100745,101085,7,0,340,2
0004bd07,100695,101145,15,3,450,2
000327fd,100975,101175,13,2,200,2
0002251f,100815,101195,11,1,380,2
0003f924,100865,101255,10,2,390,2
0003af51,100905,101295,6,2,390,2
00021823,100995,101315,14,1,320,2
0002daec,101085,101415,3,1,330,2
00036582,101125,101415,4,2,290,2
00025861,101365,101495,4,1,130,2
0001dbd4,100825,101615,15,0,790,2
0001341c,101285,101655,7,0,370,2
00018962,101205,101715,11,0,510,2
00023e94,101415,101725,11,1,310,2
0003e459,101335,101725,14,2,390,2
00015c49,101335,101755,9,0,420,2
00040b07,101415,101755,0,3,340,2
00014aed,101495,101855,7,0,360,2
0001c6f1,101285,101965,15,0,680,2
0003444e,200375,200495,1,2,120,2
00025d32,200615,200715,1,1,100,2
00042fa8,200555,200795,0,3,240,2
0001afcc,200505,200845,14,0,340,2
00042fa8,200555,200995,0,3,440,2
00037090,200945,201045,2,2,100,2
00049bd6,200705,201095,4,3,390,2
0003f197,200565,201125,7,2,560,2
00012896,200785,201205,11,0,420,2
00040493,200875,201235,0,3,360,2
00021917,201025,201325,6,1,300,2
000425c8,200965,201345,7,3,380,2
0001c7bc,201135,201385,3,0,250,2
0003e985,201185,201415,0,2,230,2
00037d7d,201045,201595,7,2,550,2
00010bad,201225,201625,11,0,400,2
00035a5f,201265,201635,4,2,370,2
00045540,201225,201725,6,3,500,2
00041af7,201365,201765,0,3,400,2
0001cd0a,201565,201785,1,0,220,2
00014ded,201335,201865,15,0,530,2
00040278,201475,201925,7,3,450,2
0004ccb4,201385,201965,7,3,580,2
00015d13,201655,202075,14,0,420,2
0002877e,300495,300615,3,1,120,2
00034cd3,300595,300655,12,2,60,2
0004f5e0,300565,300775,2,3,210,2
000302bb,300405,300795,9,2,390,2
00018e6d,300615,300835,6,0,220,2
0003442b,300825,300885,2,2,60,2
00038b5b,300735,300925,12,2,190,2
00042ad3,300485,300975,9,3,490,2
0003994b,300815,301005,12,2,190,2
00010dcf,300735,301025,8,0,290,2
00043066,300685,301135,10,3,450,2
000302f5,301095,301145,2,2,50,2
00042db0,300885,301175,4,3,290,2
00015737,300835,301205,8,0,370,2
00036bad,301135,301235,3,2,100,2
0003f8f4,301095,301345,12,2,250,2
0003adf1,301005,301405,9,2,400,2
00041f79,301435,301485,13,3,50,2
0003f95f,300955,301505,6,2,550,2
00044bc8,301215,301595,11,3,380,2
0003d02a,301285,301605,5,2,320,2
00032d9f,301425,301665,5,2,240,2
0004df00,301335,301735,5,3,400,2
000364a0,301515,301905,8,2,390,2
0001fb1a,301745,302005,12,0,260,2
00031896,301535,302045,7,2,510,2
0004b014,301655,302045,11,3,390,2
0003ef44,301625,302085,8,2,460,2
0001996b,301835,302125,13,0,290,2
0004f449,301705,302235,7,3,530,2
00042330,155,355,1,3,200,2
0002e3ed,100345,100385,1,1,40,2
000309c2,100265,100525,10,2,260,2
0003883b,100465,100595,0,2,130,2
00014ba5,100435,100715,14,0,280,2
0003df3f,100705,100775,2,2,70,2
0001d627,100365,100815,15,0,450,2
00018490,100465,100915,10,0,450,2
0003b44b,100705,100945,0,2,240,2
00014b1d,100495,100955,11,0,460,2
00037ceb,100615,101025,15,2,410,2
00040ee3,100555,101025,10,3,470,2
000195e6,100745,101085,7,0,340,2
0004bd07,100695,101145,15,3,450,2
000327fd,100975,101175,13,2,200,2
0002251f,100815,101195,11,1,380,2
0003f924,100865,101255,10,2,390,2
0003af51,100905,101295,6,2,390,2
00021823,100995,101315,14,1,320,2
0002daec,101085,101415,3,1,330,2
00036582,101125,101415,4,2,290,2
00025861,101365,101495,4,1,130,2
0001dbd4,100825,101615,15,0,790,2
0001341c,101285,101655,7,0,370,2
00018962,101205,101715,11,0,510,2
00023e94,101415,101725,11,1,310,2
0003e459,101335,101725,14,2,390,2
00015c49,101335,101755,9,0,420,2
00040b07,101415,101755,0,3,340,2
00014aed,101495,101855,7,0,360,2
0001c6f1,101285,101965,15,0,680,2
0003444e,200375,200495,1,2,120,2
00025d32,200615,200715,1,1,100,2
00042fa8,200555,200795,0,3,240,2
0001afcc,200505,200845,14,0,340,2
00042fa8,200555,200995,0,3,440,2
00037090,200945,201045,2,2,100,2
00049bd6,200705,201095,4,3,390,2
0003f197,200565,201125,7,2,560,2
00012896,200785,201205,11,0,420,2
00040493,200875,201235,0,3,360,2
00021917,201025,201325,6,1,300,2
000425c8,200965,201345,7,3,380,2
0001c7bc,201135,201385,3,0,250,2
0003e985,201185,201415,0,2,230,2
00037d7d,201045,201595,7,2,550,2
00010bad,201225,201625,11,0,400,2
00035a5f,201265,201635,4,2,370,2
00045540,201225,201725,6,3,500,2
00041af7,201365,201765,0,3,400,2
0001cd0a,201565,201785,1,0,220,2
00014ded,201335,201865,15,0,530,2
00040278,201475,201925,7,3,450,2
0004ccb4,201385,201965,7,3,580,2
00015d13,201655,202075,14,0,420,2
0002877e,300495,300615,3,1,120,2
00034cd3,300595,300655,12,2,60,2
0004f5e0,300565,300775,2,3,210,2
000302bb,300405,300795,9,2,390,2
00018e6d,300615,300835,6,0,220,2
0003442b,300825,300885,2,2,60,2
00038b5b,300735,300925,12,2,190,2
00042ad3,300485,300975,9,3,490,2
0003994b,300815,301005,12,2,190,2
00010dcf,300735,301025,8,0,290,2
00043066,300685,301135,10,3,450,2
000302f5,301095,301145,2,2,50,2
00042db0,300885,301175,4,3,290,2
00015737,300835,301205,8,0,370,2
00036bad,301135,301235,3,2,100,2
0003f8f4,301095,301345,12,2,250,2
0003adf1,301005,301405,9,2,400,2
00041f79,301435,301485,13,3,50,2
0003f95f,300955,301505,6,2,550,2
00044bc8,301215,301595,11,3,380,2
0003d02a,301285,301605,5,2,320,2
00032d9f,301425,301665,5,2,240,2
0004df00,301335,301735,5,3,400,2
000364a0,301515,301905,8,2,390,2
0001fb1a,301745,302005,12,0,260,2
00031896,301535,302045,7,2,510,2
0004b014,301655,302045,11,3,390,2
0003ef44,301625,302085,8,2,460,2
0001996b,301835,302125,13,0,290,2
0004f449,301705,302235,7,3,530,2
00015106,400515,400645,3,0,130,2
00020c49,400545,400685,0,1,140,2
0003f0b9,400635,400825,3,2,190,2
000179f6,400665,400875,5,0,210,2
000168e0,400595,400975,13,0,380,2
0004cc69,400555,400975,8,3,420,2
00047ba6,400865,401065,15,3,200,2
000322b4,400755,401075,5,2,320,2
00040883,401055,401165,2,3,110,2
000248b4,400975,401235,7,1,260,2
0004b131,400855,401285,10,3,430,2
00035a77,401135,401355,13,2,220,2
00044e41,400815,401365,9,3,550,2
000141a0,400905,401385,15,0,480,2
000237a0,401335,401475,4,1,140,2
0001835d,400855,401505,11,0,650,2
00020d45,401295,401575,0,1,280,2
000476e2,401225,401705,7,3,480,2
0002a656,401415,401735,13,1,320,2
00049ac6,401425,401755,5,3,330,2
00033d8b,401285,401805,7,2,520,2
0002d944,125,245,3,1,120,3
0002d944,125,245,3,1,120,3
00045e6a,100305,100425,13,3,120,3
00030d55,100275,100535,10,2,260,3
0003442b,100345,100575,4,2,230,3
0002a5b0,100405,100625,0,1,220,3
0003431b,100275,100655,6,2,380,3
0003fec8,100495,100755,5,2,260,3
0003fec8,100495,100895,5,2,400,3
00026361,100595,100925,8,1,330,3
00016b48,100695,100955,12,0,260,3
0003e633,100655,100955,13,2,300,3
00040e81,100565,100975,5,3,410,3
00020784,100875,100985,1,1,110,3
00019461,100815,100995,6,0,180,3
000153d2,100955,101115,1,0,160,3
000126df,100785,101155,13,0,370,3
0003a7f3,100855,101225,15,2,370,3
0001a898,100995,101255,5,0,260,3
0004f414,101235,101435,13,3,200,3
00042d29,101235,101535,5,3,300,3
0004a9fb,101165,101575,10,3,410,3
00012a67,101205,101585,12,0,380,3
00033de7,101275,101585,3,2,310,3
00017fdb,101295,101625,9,0,330,3
000304a9,101335,101625,6,2,290,3
0004c01e,101075,101675,5,3,600,3
00038080,101325,101725,3,2,400,3
0004c3fe,101205,101775,7,3,570,3
0002d944,125,245,3,1,120,3
00045e6a,100305,100425,13,3,120,3
00030d55,100275,100535,10,2,260,3
0003442b,100345,100575,4,2,230,3
0002a5b0,100405,100625,0,1,220,3
0003431b,100275,100655,6,2,380,3
0003fec8,100495,100755,5,2,260,3
0003fec8,100495,100895,5,2,400,3
00026361,100595,100925,8,1,330,3
00016b48,100695,100955,12,0,260,3
0003e633,100655,100955,13,2,300,3
00040e81,100565,100975,5,3,410,3
00020784,100875,100985,1,1,110,3
00019461,100815,100995,6,0,180,3
000153d2,100955,101115,1,0,160,3
000126df,100785,101155,13,0,370,3
0003a7f3,100855,101225,15,2,370,3
0001a898,100995,101255,5,0,260,3
0004f414,101235,101435,13,3,200,3
00042d29,101235,101535,5,3,300,3
0004a9fb,101165,101575,10,3,410,3
00012a67,101205,101585,12,0,380,3
00033de7,101275,101585,3,2,310,3
00017fdb,101295,101625,9,0,330,3
000304a9,101335,101625,6,2,290,3
0004c01e,101075,101675,5,3,600,3
00038080,101325,101725,3,2,400,3
0004c3fe,101205,101775,7,3,570,3
00040c8b,200365,200485,13,3,120,3
0003ecb3,200455,200545,2,2,90,3
0004d066,200305,200605,0,3,300,3
0002161c,200445,200635,12,1,190,3
00038502,200315,200645,5,2,330,3
0002917d,200375,200715,8,1,340,3
0001bd1f,200585,200845,12,0,260,3
0002d8eb,200515,200905,13,1,390,3
00042555,200535,200945,6,3,410,3
00042555,200535,201045,6,3,510,3
00010df2,200705,201095,3,0,390,3
0002ee1b,200625,201105,14,1,480,3
0003ac47,200675,201135,15,2,460,3
000346ec,200865,201195,10,2,330,3
0001b2f1,200805,201295,10,0,490,3
0002d944,125,245,3,1,120,3
00045e6a,100305,100425,13,3,120,3
00030d55,100275,100535,10,2,260,3
0003442b,100345,100575,4,2,230,3
0002a5b0,100405,100625,0,1,220,3
0003431b,100275,100655,6,2,380,3
0003fec8,100495,100755,5,2,260,3
0003fec8,100495,100895,5,2,400,3
00026361,100595,100925,8,1,330,3
00016b48,100695,100955,12,0,260,3
0003e633,100655,100955,13,2,300,3
00040e81,100565,100975,5,3,410,3
00020784,100875,100985,1,1,110,3
00019461,100815,100995,6,0,180,3
000153d2,100955,101115,1,0,160,3
000126df,100785,101155,13,0,370,3
0003a7f3,100855,101225,15,2,370,3
0001a898,100995,101255,5,0,260,3
0004f414,101235,101435,13,3,200,3
00042d29,101235,101535,5,3,300,3
0004a9fb,101165,101575,10,3,410,3
00012a67,101205,101585,12,0,380,3
00033de7,101275,101585,3,2,310,3
00017fdb,101295,101625,9,0,330,3
000304a9,101335,101625,6,2,290,3
0004c01e,101075,101675,5,3,600,3
00038080,101325,101725,3,2,400,3
0004c3fe,101205,101775,7,3,570,3
00040c8b,200365,200485,13,3,120,3
0003ecb3,200455,200545,2,2,90,3
0004d066,200305,200605,0,3,300,3
0002161c,200445,200635,12,1,190,3
00038502,200315,200645,5,2,330,3
0002917d,200375,200715,8,1,340,3
0001bd1f,200585,200845,12,0,260,3
0002d8eb,200515,200905,13,1,390,3
00042555,200535,200945,6,3,410,3
00042555,200535,201045,6,3,510,3
00010df2,200705,201095,3,0,390,3
0002ee1b,200625,201105,14,1,480,3
0003ac47,200675,201135,15,2,460,3
000346ec,200865,201195,10,2,330,3
0001b2f1,200805,201295,10,0,490,3
000486d6,300415,300475,12,3,60,3
00041cca,300545,300725,1,3,180,3
0001da58,300605,300845,3,0,240,3
000143e6,300505,300885,15,0,380,3
0004ce2d,300655,300905,1,3,250,3
00013423,300865,300965,0,0,100,3
000376d7,300925,300975,2,2,50,3
000255df,300775,301055,9,1,280,3
00039d44,300825,301055,4,2,230,3
0003740b,300925,301095,2,2,170,3
000255f4,300855,301175,4,1,320,3
00044081,300725,301175,6,3,450,3
00019f50,300965,301195,8,0,230,3
0004f69e,300755,301295,5,3,540,3
0001b9b1,300865,301305,14,0,440,3
00033c71,300905,301355,9,2,450,3
0002ecc8,300855,301405,15,1,550,3
00014117,301055,301475,10,0,420,3
00026ce7,301095,301525,11,1,430,3
0001b03a,301095,301675,10,0,580,3
0002d944,125,245,3,1,120,3
00045e6a,100305,100425,13,3,120,3
00030d55,100275,100535,10,2,260,3
0003442b,100345,100575,4,2,230,3
0002a5b0,100405,100625,0,1,220,3
0003431b,100275,100655,6,2,380,3
0003fec8,100495,100755,5,2,260,3
0003fec8,100495,100895,5,2,400,3
00026361,100595,100925,8,1,330,3
00016b48,100695,100955,12,0,260,3
0003e633,100655,100955,13,2,300,3
00040e81,100565,100975,5,3,410,3
00020784,100875,100985,1,1,110,3
00019461,100815,100995,6,0,180,3
000153d2,100955,101115,1,0,160,3
000126df,100785,101155,13,0,370,3
0003a7f3,100855,101225,15,2,370,3
0001a898,100995,101255,5,0,260,3
0004f414,101235,101435,13,3,200,3
00042d29,101235,101535,5,3,300,3
0004a9fb,101165,101575,10,3,410,3
00012a67,101205,101585,12,0,380,3
00033de7,101275,101585,3,2,310,3
00017fdb,101295,101625,9,0,330,3
000304a9,101335,101625,6,2,290,3
0004c01e,101075,101675,5,3,600,3
00038080,101325,101725,3,2,400,3
0004c3fe,101205,101775,7,3,570,3
00040c8b,200365,200485,13,3,120,3
0003ecb3,200455,200545,2,2,90,3
0004d066,200305,200605,0,3,300,3
0002161c,200445,200635,12,1,190,3
00038502,200315,200645,5,2,330,3
0002917d,200375,200715,8,1,340,3
0001bd1f,200585,200845,12,0,260,3
0002d8eb,200515,200905,13,1,390,3
00042555,200535,200945,6,3,410,3
00042555,200535,201045,6,3,510,3
00010df2,200705,201095,3,0,390,3
0002ee1b,200625,201105,14,1,480,3
0003ac47,200675,201135,15,2,460,3
000346ec,200865,201195,10,2,330,3
0001b2f1,200805,201295,10,0,490,3
000486d6,300415,300475,12,3,60,3
00041cca,300545,300725,1,3,180,3
0001da58,300605,300845,3,0,240,3
000143e6,300505,300885,15,0,380,3
0004ce2d,300655,300905,1,3,250,3
00013423,300865,300965,0,0,100,3
000376d7,300925,300975,2,2,50,3
000255df,300775,301055,9,1,280,3
00039d44,300825,301055,4,2,230,3
0003740b,300925,301095,2,2,170,3
000255f4,300855,301175,4,1,320,3
00044081,300725,301175,6,3,450,3
00019f50,300965,301195,8,0,230,3
0004f69e,300755,301295,5,3,540,3
0001b9b1,300865,301305,14,0,440,3
00033c71,300905,301355,9,2,450,3
0002ecc8,300855,301405,15,1,550,3
00014117,301055,301475,10,0,420,3
00026ce7,301095,301525,11,1,430,3
0001b03a,301095,301675,10,0,580,3
00029cee,400545,400665,0,1,120,3
00037bce,400705,400895,0,2,190,3
000191ee,400496,400925,15,0,429,3
0001610a,400635,400965,11,0,330,3
0003d723,400735,400965,13,2,230,3
00048085,400905,401155,0,3,250,3
00029f1a,400825,401175,6,1,350,3
00039963,400925,401225,9,2,300,3
00028cfd,400995,401275,5,1,280,3
000315a0,400925,401305,9,2,380,3
00015344,401095,401345,6,0,250,3
0004db56,401275,401345,12,3,70,3
0003a9f6,401305,401485,13,2,180,3
00032a36,401005,401525,15,2,520,3
000464bf,401185,401535,15,3,350,3
00028482,401495,401545,1,1,50,3
00049513,401395,401795,6,3,400,3
0003c84a,401555,401825,13,2,270,3
0001447d,401705,401895,5,0,190,3
0002ecfa,401775,401965,0,1,190,3
0004c093,401415,402005,7,3,590,3
00040428,402015,402085,12,3,70,3
0001b59f,401625,402095,15,0,470,3
0001e8a7,401845,402175,9,0,330,3
00036e73,401875,402185,6,2,310,3
00015870,401615,402215,15,0,600,3
000459f8,402115,402395,5,3,280,3
00014714,402155,402425,3,0,270,3
00010819,402065,402465,9,0,400,3
0002cde4,401945,402475,15,1,530,3
00048f9f,401905,402495,8,3,590,3
00031daf,402165,402545,11,2,380,3
00014a47,165,425,8,0,260,13
00014a47,165,425,8,0,260,13
00025408,100225,100265,1,1,40,13
00017074,100235,100455,6,0,220,13
000328c0,100235,100455,14,2,220,13
00014a47,165,425,8,0,260,13
00025408,100225,100265,1,1,40,13
00017074,100235,100455,6,0,220,13
000328c0,100235,100455,14,2,220,13
0002d4c3,200305,200385,2,1,80,13
0001e818,200365,200405,0,0,40,13
00044fd3,200455,200575,13,3,120,13
0001a965,200495,200835,13,0,340,13
0004bf8d,200665,200865,13,3,200,13
0004e200,200565,200905,5,3,340,13
0002f12a,200745,200915,3,1,170,13
00047509,200665,200965,15,3,300,13
0004e4b7,200565,201005,9,3,440,13
00016c50,200715,201015,8,0,300,13
00039676,200625,201065,6,2,440,13
00014a47,165,425,8,0,260,13
00025408,100225,100265,1,1,40,13
00017074,100235,100455,6,0,220,13
000328c0,100235,100455,14,2,220,13
0002d4c3,200305,200385,2,1,80,13
0001e818,200365,200405,0,0,40,13
00044fd3,200455,200575,13,3,120,13
0001a965,200495,200835,13,0,340,13
0004bf8d,200665,200865,13,3,200,13
0004e200,200565,200905,5,3,340,13
0002f12a,200745,200915,3,1,170,13
00047509,200665,200965,15,3,300,13
0004e4b7,200565,201005,9,3,440,13
00016c50,200715,201015,8,0,300,13
00039676,200625,201065,6,2,440,13
00047d2d,300435,300655,0,3,220,13
0002d22d,300535,300785,6,1,250,13
00014f7c,300555,300815,3,0,260,13
0002202f,300565,300855,12,1,290,13
00025cfe,300565,300955,6,1,390,13
00015659,300645,301035,10,0,390,13
000280bb,300755,301055,10,1,300,13
00043c91,300955,301055,12,3,100,13
00026737,300675,301095,11,1,420,13
00045d91,300825,301095,15,3,270,13
0004cd8a,300525,301135,7,3,610,13
00031a7f,300875,301205,5,2,330,13
0002d512,301195,301235,4,1,40,13
0001038a,300905,301315,13,0,410,13
0002d512,301195,301335,4,1,140,13
0004c532,300785,301335,6,3,550,13
00010cf5,301105,301415,8,0,310,13
0001879b,301265,301725,11,0,460,13
00014a47,165,425,8,0,260,13
00025408,100225,100265,1,1,40,13
00017074,100235,100455,6,0,220,13
000328c0,100235,100455,14,2,220,13
0002d4c3,200305,200385,2,1,80,13
0001e818,200365,200405,0,0,40,13
00044fd3,200455,200575,13,3,120,13
0001a965,200495,200835,13,0,340,13
0004bf8d,200665,200865,13,3,200,13
0004e200,200565,200905,5,3,340,13
0002f12a,200745,200915,3,1,170,13
00047509,200665,200965,15,3,300,13
0004e4b7,200565,201005,9,3,440,13
00016c50,200715,201015,8,0,300,13
00039676,200625,201065,6,2,440,13
00047d2d,300435,300655,0,3,220,13
0002d22d,300535,300785,6,1,250,13
00014f7c,300555,300815,3,0,260,13
0002202f,300565,300855,12,1,290,13
00025cfe,300565,300955,6,1,390,13
00015659,300645,301035,10,0,390,13
000280bb,300755,301055,10,1,300,13
00043c91,300955,301055,12,3,100,13
00026737,300675,301095,11,1,420,13
00045d91,300825,301095,15,3,270,13
0004cd8a,300525,301135,7,3,610,13
00031a7f,300875,301205,5,2,330,13
0002d512,301195,301235,4,1,40,13
0001038a,300905,301315,13,0,410,13
0002d512,301195,301335,4,1,140,13
0004c532,300785,301335,6,3,550,13
00010cf5,301105,301415,8,0,310,13
0001879b,301265,301725,11,0,460,13
000360ab,400715,400755,2,2,40,13
0002546f,400685,400825,12,1,140,13
0001ac13,400585,400895,9,0,310,13
0001fc48,400745,400935,6,0,190,13
0004a651,400905,400985,3,3,80,13
0001fc48,400745,401035,6,0,290,13
000370c9,400825,401055,14,2,230,13
00048076,400505,401065,7,3,560,13
0001a58e,401055,401175,1,0,120,13
00018e5e,400995,401265,3,0,270,13
000148ae,401055,401365,12,0,310,13
0001978c,401365,401445,4,0,80,13
0004a6d7,400955,401495,7,3,540,13
0002df63,401215,401605,7,1,390,13
0002c4af,401305,401665,14,1,360,13
0003cfc8,401145,401675,5,2,530,13
00022b31,401385,401795,14,1,410,13
0003a23a,401305,401795,7,2,490,13
0001d544,401255,401945,11,0,690,13
0004b79d,115,315,1,3,200,14
0004b79d,115,315,1,3,200,14
00028392,100215,100295,2,1,80,14
0003cba2,100215,100365,12,2,150,14
00040207,100315,100395,13,3,80,14
0004b79d,115,315,1,3,200,14
00028392,100215,100295,2,1,80,14
0003cba2,100215,100365,12,2,150,14
00040207,100315,100395,13,3,80,14
000477ed,100325,100455,1,3,130,14
00026429,100295,100565,10,1,270,14
00014e70,100365,100645,9,0,280,14
00041cc5,100585,100735,14,3,150,14
00011164,100525,100845,7,0,320,14
0001a84c,100435,100925,9,0,490,14
0004bc7f,200355,200475,2,3,120,14
00012913,200535,200565,0,0,30,14
00037fe3,200505,200645,13,2,140,14
000434b6,200305,200735,6,3,430,14
0004f2c8,200505,200805,10,3,300,14
00048b46,200325,200885,8,3,560,14
0002acc7,200455,200965,8,1,510,14
000472ca,200395,200965,8,3,570,14
0003b893,200595,201155,8,2,560,14
0004b79d,115,315,1,3,200,14
00028392,100215,100295,2,1,80,14
0003cba2,100215,100365,12,2,150,14
00040207,100315,100395,13,3,80,14
000477ed,100325,100455,1,3,130,14
00026429,100295,100565,10,1,270,14
00014e70,100365,100645,9,0,280,14
00041cc5,100585,100735,14,3,150,14
00011164,100525,100845,7,0,320,14
0001a84c,100435,100925,9,0,490,14
0004bc7f,200355,200475,2,3,120,14
00012913,200535,200565,0,0,30,14
00037fe3,200505,200645,13,2,140,14
000434b6,200305,200735,6,3,430,14
0004f2c8,200505,200805,10,3,300,14
00048b46,200325,200885,8,3,560,14
0002acc7,200455,200965,8,1,510,14
000472ca,200395,200965,8,3,570,14
0003b893,200595,201155,8,2,560,14
0004dca3,300425,300585,1,3,160,14
00031b97,300455,300605,12,2,150,14
0001436b,300615,300655,0,0,40,14
0002b84b,300565,300845,14,1,280,14
000363ff,300485,300865,9,2,380,14
00040217,300645,301135,7,3,490,14
0004b79d,115,315,1,3,200,14
00028392,100215,100295,2,1,80,14
0003cba2,100215,100365,12,2,150,14
00040207,100315,100395,13,3,80,14
000477ed,100325,100455,1,3,130,14
00026429,100295,100565,10,1,270,14
00014e70,100365,100645,9,0,280,14
00041cc5,100585,100735,14,3,150,14
00011164,100525,100845,7,0,320,14
0001a84c,100435,100925,9,0,490,14
0004bc7f,200355,200475,2,3,120,14
00012913,200535,200565,0,0,30,14
00037fe3,200505,200645,13,2,140,14
000434b6,200305,200735,6,3,430,14
0004f2c8,200505,200805,10,3,300,14
00048b46,200325,200885,8,3,560,14
0002acc7,200455,200965,8,1,510,14
000472ca,200395,200965,8,3,570,14
0003b893,200595,201155,8,2,560,14
0004dca3,300425,300585,1,3,160,14
00031b97,300455,300605,12,2,150,14
0001436b,300615,300655,0,0,40,14
0002b84b,300565,300845,14,1,280,14
000363ff,300485,300865,9,2,380,14
00040217,300645,301135,7,3,490,14
00030cbb,400595,400675,3,2,80,14
00012126,400595,400715,2,0,120,14
00041b4b,400535,400745,14,3,210,14
00026a85,400755,401025,6,1,270,14
00015d3f,400685,401075,3,0,390,14
000310b5,400695,401095,7,2,400,14
0001f9e3,400645,401195,14,0,550,14
00022862,400785,401265,3,1,480,14
00039f40,185,285,12,2,100,6
00039f40,185,285,12,2,100,6
0001632a,100205,100505,9,0,300,6
00039f40,185,285,12,2,100,6
0001632a,100205,100505,9,0,300,6
0001cf42,200365,200405,0,0,40,6
0001e913,200345,200705,11,0,360,6
00039f40,185,285,12,2,100,6
0001632a,100205,100505,9,0,300,6
0001cf42,200365,200405,0,0,40,6
0001e913,200345,200705,11,0,360,6
0003d8ab,300495,300655,13,2,160,6
0004241c,300565,300735,0,3,170,6
0002b635,300495,300785,5,1,290,6
00049bd3,300405,300815,15,3,410,6
0001fd07,300665,300895,12,0,230,6
0004230e,300665,300915,13,3,250,6
00015fb1,300605,300935,7,0,330,6
0003fcb9,300825,300975,1,2,150,6
00048656,300755,301105,9,3,350,6
0004446f,301065,301165,12,3,100,6
00017f90,300795,301245,9,0,450,6
000226bb,301095,301305,5,1,210,6
0002dd71,300885,301385,9,1,500,6
0002db62,300975,301425,8,1,450,6
000433f4,301095,301445,9,3,350,6
00039f40,185,285,12,2,100,6
0001632a,100205,100505,9,0,300,6
0001cf42,200365,200405,0,0,40,6
0001e913,200345,200705,11,0,360,6
0003d8ab,300495,300655,13,2,160,6
0004241c,300565,300735,0,3,170,6
0002b635,300495,300785,5,1,290,6
00049bd3,300405,300815,15,3,410,6
0001fd07,300665,300895,12,0,230,6
0004230e,300665,300915,13,3,250,6
00015fb1,300605,300935,7,0,330,6
0003fcb9,300825,300975,1,2,150,6
00048656,300755,301105,9,3,350,6
0004446f,301065,301165,12,3,100,6
00017f90,300795,301245,9,0,450,6
000226bb,301095,301305,5,1,210,6
0002dd71,300885,301385,9,1,500,6
0002db62,300975,301425,8,1,450,6
000433f4,301095,301445,9,3,350,6
000325a7,400545,400845,11,2,300,6
00011229,400605,400865,8,0,260,6
00030347,400545,400885,4,2,340,6
00017151,400895,401075,2,0,180,6
0001fb57,400685,401115,6,0,430,6
0002fbf7,400685,401135,6,1,450,6
0001eed9,400985,401195,3,0,210,6
000409ed,400835,401205,9,3,370,6
0001ea41,400775,401295,11,0,520,6
00012983,401095,401335,7,0,240,6
0001036c,401015,401415,3,0,400,6
00040e80,401165,401465,4,3,300,6
0001b8a3,401245,401555,9,0,310,6
00024cad,401315,401575,5,1,260,6
000438d9,401505,401575,12,3,70,6
00015a16,401085,401595,11,0,510,6
0002070b,401445,401615,4,1,170,6
0001e6bb,401245,401695,13,0,450,6
00017d03,401695,401755,4,0,60,6
0001739b,401385,401815,9,0,430,6
000238ef,401505,401825,7,1,320,6
0004df52,401555,401835,0,3,280,6
00021fd3,401585,401905,0,1,320,6
000203e8,401655,401985,13,1,330,6
00010a7f,401585,401995,10,0,410,6
0002c065,105,285,4,1,180,16
0002c065,105,285,4,1,180,16
000197bd,100255,100435,12,0,180,16
00041d8c,100335,100755,6,3,420,16
00047dcc,100415,101005,7,3,590,16
0002c065,105,285,4,1,180,16
000197bd,100255,100435,12,0,180,16
00041d8c,100335,100755,6,3,420,16
00047dcc,100415,101005,7,3,590,16
00014073,200445,200525,1,0,80,16
0001bbff,200525,200595,4,0,70,16
0003cb23,200365,200625,10,2,260,16
00012713,200635,200735,0,0,100,16
000253c2,200555,200755,4,1,200,16
0004aed0,200535,200925,8,3,390,16
0001e55d,200555,200965,12,0,410,16
0002c065,105,285,4,1,180,16
000197bd,100255,100435,12,0,180,16
00041d8c,100335,100755,6,3,420,16
00047dcc,100415,101005,7,3,590,16
00014073,200445,200525,1,0,80,16
0001bbff,200525,200595,4,0,70,16
0003cb23,200365,200625,10,2,260,16
00012713,200635,200735,0,0,100,16
000253c2,200555,200755,4,1,200,16
0004aed0,200535,200925,8,3,390,16
0001e55d,200555,200965,12,0,410,16
00020408,300485,300525,1,1,40,16
0004f073,300485,300745,11,3,260,16
0004850a,300505,300835,5,3,330,16
0001595f,300695,301065,10,0,370,16
0004bf38,300555,301065,6,3,510,16
0003711c,300775,301075,0,2,300,16
0004b5e7,301045,301105,3,3,60,16
0003e846,300745,301135,15,2,390,16
00038eca,300955,301195,1,2,240,16
0003e846,300745,301255,15,2,510,16
0004934c,300625,301335,5,3,710,16
000315f3,301095,301375,3,2,280,16
0003f79b,300865,301415,8,2,550,16
00041295,300865,301415,7,3,550,16
00030516,301185,301495,5,2,310,16
00022270,301235,301545,14,1,310,16
000126ca,301185,301555,9,0,370,16
00046093,301325,301705,10,3,380,16
0002c065,105,285,4,1,180,16
000197bd,100255,100435,12,0,180,16
00041d8c,100335,100755,6,3,420,16
00047dcc,100415,101005,7,3,590,16
00014073,200445,200525,1,0,80,16
0001bbff,200525,200595,4,0,70,16
0003cb23,200365,200625,10,2,260,16
00012713,200635,200735,0,0,100,16
000253c2,200555,200755,4,1,200,16
0004aed0,200535,200925,8,3,390,16
0001e55d,200555,200965,12,0,410,16
00020408,300485,300525,1,1,40,16
0004f073,300485,300745,11,3,260,16
0004850a,300505,300835,5,3,330,16
0001595f,300695,301065,10,0,370,16
0004bf38,300555,301065,6,3,510,16
0003711c,300775,301075,0,2,300,16
0004b5e7,301045,301105,3,3,60,16
0003e846,300745,301135,15,2,390,16
00038eca,300955,301195,1,2,240,16
0003e846,300745,301255,15,2,510,16
0004934c,300625,301335,5,3,710,16
000315f3,301095,301375,3,2,280,16
0003f79b,300865,301415,8,2,550,16
00041295,300865,301415,7,3,550,16
00030516,301185,301495,5,2,310,16
00022270,301235,301545,14,1,310,16
000126ca,301185,301555,9,0,370,16
00046093,301325,301705,10,3,380,16
0003d9c7,400525,400685,13,2,160,16
00047b4d,400605,400925,4,3,320,16
000153bf,400725,400945,2,0,220,16
000395fb,400645,401015,6,2,370,16
0001f83c,401005,401075,4,0,70,16
00023f16,400855,401125,9,1,270,16
0001a82b,400795,401155,7,0,360,16
0002648d,401145,401265,2,1,120,16
0004c7c0,401045,401305,11,3,260,16
0004812c,401025,401345,10,3,320,16
0003a1a4,400945,401355,6,2,410,16
0002d18b,400985,401445,7,1,460,16
00014439,400965,401455,11,0,490,16
0004b083,401115,401485,15,3,370,16
00016008,401165,401555,5,0,390,16
0003c199,96,175,3,2,79,16
0003c199,96,175,3,2,79,16
000228ce,100245,100285,1,1,40,16
00037448,100275,100465,0,2,190,16
000469b3,100355,100465,2,3,110,16
00020389,100255,100625,7,1,370,16
00030b06,100315,100625,11,2,310,16
0003c199,96,175,3,2,79,16
000228ce,100245,100285,1,1,40,16
00037448,100275,100465,0,2,190,16
000469b3,100355,100465,2,3,110,16
00020389,100255,100625,7,1,370,16
00030b06,100315,100625,11,2,310,16
0002bf2a,200325,200445,3,1,120,16
00046a71,200335,200495,14,3,160,16
0002a02a,200455,200605,4,1,150,16
0003e0fc,200325,200735,11,2,410,16
000429db,200515,200785,14,3,270,16
0004b80b,200635,200825,1,3,190,16
000291be,200445,200965,8,1,520,16
0004e795,200425,200985,8,3,560,16
00033efd,200675,200995,4,2,320,16
0003f0ff,200935,201035,2,2,100,16
0003bd1c,200935,201075,3,2,140,16
000311d2,200555,201115,8,2,560,16
0004b316,200705,201215,7,3,510,16
00037766,200955,201245,6,2,290,16
0002418c,201045,201305,4,1,260,16
000116d2,201195,201335,5,0,140,16
0004da1a,200865,201335,6,3,470,16
0002dc56,200785,201385,8,1,600,16
000467db,201175,201435,2,3,260,16
00018eec,201125,201475,13,0,350,16
000246d9,201045,201485,8,1,440,16
0002a007,201245,201545,7,1,300,16
000216d6,201415,201645,4,1,230,16
00014f3c,201555,201655,5,0,100,16
0003f92b,201435,201695,13,2,260,16
00016cb8,201325,201765,10,0,440,16
000488fd,201655,201765,3,3,110,16
0003ffae,201495,201775,14,2,280,16
0004a5c4,201375,201895,9,3,520,16
0003eb8c,201565,201985,6,2,420,16
0003c199,96,175,3,2,79,16
000228ce,100245,100285,1,1,40,16
00037448,100275,100465,0,2,190,16
000469b3,100355,100465,2,3,110,16
00020389,100255,100625,7,1,370,16
00030b06,100315,100625,11,2,310,16
0002bf2a,200325,200445,3,1,120,16
00046a71,200335,200495,14,3,160,16
0002a02a,200455,200605,4,1,150,16
0003e0fc,200325,200735,11,2,410,16
000429db,200515,200785,14,3,270,16
0004b80b,200635,200825,1,3,190,16
000291be,200445,200965,8,1,520,16
0004e795,200425,200985,8,3,560,16
00033efd,200675,200995,4,2,320,16
0003f0ff,200935,201035,2,2,100,16
0003bd1c,200935,201075,3,2,140,16
000311d2,200555,201115,8,2,560,16
0004b316,200705,201215,7,3,510,16
00037766,200955,201245,6,2,290,16
0002418c,201045,201305,4,1,260,16
000116d2,201195,201335,5,0,140,16
0004da1a,200865,201335,6,3,470,16
0002dc56,200785,201385,8,1,600,16
000467db,201175,201435,2,3,260,16
00018eec,201125,201475,13,0,350,16
000246d9,201045,201485,8,1,440,16
0002a007,201245,201545,7,1,300,16
000216d6,201415,201645,4,1,230,16
00014f3c,201555,201655,5,0,100,16
0003f92b,201435,201695,13,2,260,16
00016cb8,201325,201765,10,0,440,16
000488fd,201655,201765,3,3,110,16
0003ffae,201495,201775,14,2,280,16
0004a5c4,201375,201895,9,3,520,16
0003eb8c,201565,201985,6,2,420,16
00021d36,300455,300715,9,1,260,16
000112a4,300515,300775,8,0,260,16
000448bf,300605,300985,7,3,380,16
0002cf7c,300975,301035,4,1,60,16
0001f6cb,300685,301095,8,0,410,16
00013287,300825,301195,13,0,370,16
0003f178,300755,301195,9,2,440,16
0001601f,301185,301235,4,0,50,16
0001c50a,301185,301275,1,0,90,16
000457d8,300575,301295,8,3,720,16
0001525e,300905,301315,11,0,410,16
00033d80,300925,301345,7,2,420,16
0002da0f,301065,301555,7,1,490,16
0001aa18,301145,301595,8,0,450,16
00032f22,300945,301595,7,2,650,16
00019604,301245,301695,7,0,450,16
00027b92,301335,301695,8,1,360,16
0003c199,96,175,3,2,79,16
000228ce,100245,100285,1,1,40,16
00037448,100275,100465,0,2,190,16
000469b3,100355,100465,2,3,110,16
00020389,100255,100625,7,1,370,16
00030b06,100315,100625,11,2,310,16
0002bf2a,200325,200445,3,1,120,16
00046a71,200335,200495,14,3,160,16
0002a02a,200455,200605,4,1,150,16
0003e0fc,200325,200735,11,2,410,16
000429db,200515,200785,14,3,270,16
0004b80b,200635,200825,1,3,190,16
000291be,200445,200965,8,1,520,16
0004e795,200425,200985,8,3,560,16
00033efd,200675,200995,4,2,320,16
0003f0ff,200935,201035,2,2,100,16
0003bd1c,200935,201075,3,2,140,16
000311d2,200555,201115,8,2,560,16
0004b316,200705,201215,7,3,510,16
00037766,200955,201245,6,2,290,16
0002418c,201045,201305,4,1,260,16
000116d2,201195,201335,5,0,140,16
0004da1a,200865,201335,6,3,470,16
0002dc56,200785,201385,8,1,600,16
000467db,201175,201435,2,3,260,16
00018eec,201125,201475,13,0,350,16
000246d9,201045,201485,8,1,440,16
0002a007,201245,201545,7,1,300,16
000216d6,201415,201645,4,1,230,16
00014f3c,201555,201655,5,0,100,16
0003f92b,201435,201695,13,2,260,16
00016cb8,201325,201765,10,0,440,16
000488fd,201655,201765,3,3,110,16
0003ffae,201495,201775,14,2,280,16
0004a5c4,201375,201895,9,3,520,16
0003eb8c,201565,201985,6,2,420,16
00021d36,300455,300715,9,1,260,16
000112a4,300515,300775,8,0,260,16
000448bf,300605,300985,7,3,380,16
0002cf7c,300975,301035,4,1,60,16
0001f6cb,300685,301095,8,0,410,16
00013287,300825,301195,13,0,370,16
0003f178,300755,301195,9,2,440,16
0001601f,301185,301235,4,0,50,16
0001c50a,301185,301275,1,0,90,16
000457d8,300575,301295,8,3,720,16
0001525e,300905,301315,11,0,410,16
00033d80,300925,301345,7,2,420,16
0002da0f,301065,301555,7,1,490,16
0001aa18,301145,301595,8,0,450,16
00032f22,300945,301595,7,2,650,16
00019604,301245,301695,7,0,450,16
00027b92,301335,301695,8,1,360,16
0001348e,400585,400665,1,0,80,16
00014ec2,400735,400825,0,0,90,16
000400f4,400765,400825,12,3,60,16
0001aae2,400525,400885,7,0,360,16
00044ae7,400735,400925,1,3,190,16
00034f96,400615,401015,5,2,400,16
00016c5a,400855,401025,2,0,170,16
00018dfb,400745,401065,8,0,320,16
0001664d,400995,401105,4,0,110,16
000315c7,400695,401115,6,2,420,16
0001e176,400735,401165,13,0,430,16
00024aea,400925,401175,13,1,250,16
00011438,400855,401305,11,0,450,16
00024b7f,401065,401315,6,1,250,16
0004e1a3,401135,401385,11,3,250,16
00020221,401015,401435,7,1,420,16
0002a4e5,401305,401475,0,1,170,16
0004401a,401275,401615,10,3,340,16
00030ca8,401065,401625,7,2,560,16
0003bcaf,401085,401665,8,2,580,16
0001c046,401255,401725,7,0,470,16
000343d5,155,195,2,2,40,3
000343d5,155,195,2,2,40,3
0004db03,100285,100545,0,3,260,3
0001c1d6,100415,100605,0,0,190,3
0003431f,100405,100625,0,2,220,3
0002bbc2,100625,100715,1,1,90,3
00018e83,100345,100745,14,0,400,3
00023b6b,100465,100775,14,1,310,3
00045016,100625,100845,11,3,220,3
00018072,100715,100875,1,0,160,3
00033978,100565,100905,4,2,340,3
00022398,100545,100915,15,1,370,3
0003d402,100705,100995,0,2,290,3
0003c512,100815,101055,12,2,240,3
0002e3ba,100795,101075,6,1,280,3
000344f2,100985,101155,3,2,170,3
00017367,101175,101225,4,0,50,3
00017595,100885,101325,14,0,440,3
0001bd4c,100965,101425,11,0,460,3
0002186a,101395,101505,5,1,110,3
00015e4a,101035,101555,11,0,520,3
000391df,101235,101645,15,2,410,3
000131f5,101365,101665,12,0,300,3
0004287b,101125,101685,6,3,560,3
0001cbe6,101325,101705,8,0,380,3
000322a1,101475,101765,11,2,290,3
000343d5,155,195,2,2,40,3
0004db03,100285,100545,0,3,260,3
0001c1d6,100415,100605,0,0,190,3
0003431f,100405,100625,0,2,220,3
0002bbc2,100625,100715,1,1,90,3
00018e83,100345,100745,14,0,400,3
00023b6b,100465,100775,14,1,310,3
00045016,100625,100845,11,3,220,3
00018072,100715,100875,1,0,160,3
00033978,100565,100905,4,2,340,3
00022398,100545,100915,15,1,370,3
0003d402,100705,100995,0,2,290,3
0003c512,100815,101055,12,2,240,3
0002e3ba,100795,101075,6,1,280,3
000344f2,100985,101155,3,2,170,3
00017367,101175,101225,4,0,50,3
00017595,100885,101325,14,0,440,3
0001bd4c,100965,101425,11,0,460,3
0002186a,101395,101505,5,1,110,3
00015e4a,101035,101555,11,0,520,3
000391df,101235,101645,15,2,410,3
000131f5,101365,101665,12,0,300,3
0004287b,101125,101685,6,3,560,3
0001cbe6,101325,101705,8,0,380,3
000322a1,101475,101765,11,2,290,3
0003bdcc,200355,200645,11,2,290,3
00048f88,200565,200655,2,3,90,3
000300e2,200485,200705,14,2,220,3
0001365f,200625,200735,1,0,110,3
0003ced2,200435,200775,6,2,340,3
00010b46,200735,200865,5,0,130,3
00022ba5,200585,200905,8,1,320,3
00024b66,200895,200965,2,1,70,3
00024205,200665,201005,5,1,340,3
0004ca6b,200845,201005,13,3,160,3
0002ef2f,200975,201065,1,1,90,3
000402b3,200555,201105,7,3,550,3
0001ac3b,200825,201195,9,0,370,3
000343d5,155,195,2,2,40,3
0004db03,100285,100545,0,3,260,3
0001c1d6,100415,100605,0,0,190,3
0003431f,100405,100625,0,2,220,3
0002bbc2,100625,100715,1,1,90,3
00018e83,100345,100745,14,0,400,3
00023b6b,100465,100775,14,1,310,3
00045016,100625,100845,11,3,220,3
00018072,100715,100875,1,0,160,3
00033978,100565,100905,4,2,340,3
00022398,100545,100915,15,1,370,3
0003d402,100705,100995,0,2,290,3
0003c512,100815,101055,12,2,240,3
0002e3ba,100795,101075,6,1,280,3
000344f2,100985,101155,3,2,170,3
00017367,101175,101225,4,0,50,3
00017595,100885,101325,14,0,440,3
0001bd4c,100965,101425,11,0,460,3
0002186a,101395,101505,5,1,110,3
00015e4a,101035,101555,11,0,520,3
000391df,101235,101645,15,2,410,3
000131f5,101365,101665,12,0,300,3
0004287b,101125,101685,6,3,560,3
0001cbe6,101325,101705,8,0,380,3
000322a1,101475,101765,11,2,290,3
0003bdcc,200355,200645,11,2,290,3
00048f88,200565,200655,2,3,90,3
000300e2,200485,200705,14,2,220,3
0001365f,200625,200735,1,0,110,3
0003ced2,200435,200775,6,2,340,3
00010b46,200735,200865,5,0,130,3
00022ba5,200585,200905,8,1,320,3
00024b66,200895,200965,2,1,70,3
00024205,200665,201005,5,1,340,3
0004ca6b,200845,201005,13,3,160,3
0002ef2f,200975,201065,1,1,90,3
000402b3,200555,201105,7,3,550,3
0001ac3b,200825,201195,9,0,370,3
00023b5b,300396,300515,3,1,119,3
00023b77,300435,300705,10,1,270,3
000343d5,155,195,2,2,40,3
0004db03,100285,100545,0,3,260,3
0001c1d6,100415,100605,0,0,190,3
0003431f,100405,100625,0,2,220,3
0002bbc2,100625,100715,1,1,90,3
00018e83,100345,100745,14,0,400,3
00023b6b,100465,100775,14,1,310,3
00045016,100625,100845,11,3,220,3
00018072,100715,100875,1,0,160,3
00033978,100565,100905,4,2,340,3
00022398,100545,100915,15,1,370,3
0003d402,100705,100995,0,2,290,3
0003c512,100815,101055,12,2,240,3
0002e3ba,100795,101075,6,1,280,3
000344f2,100985,101155,3,2,170,3
00017367,101175,101225,4,0,50,3
00017595,100885,101325,14,0,440,3
0001bd4c,100965,101425,11,0,460,3
0002186a,101395,101505,5,1,110,3
00015e4a,101035,101555,11,0,520,3
000391df,101235,101645,15,2,410,3
000131f5,101365,101665,12,0,300,3
0004287b,101125,101685,6,3,560,3
0001cbe6,101325,101705,8,0,380,3
000322a1,101475,101765,11,2,290,3
0003bdcc,200355,200645,11,2,290,3
00048f88,200565,200655,2,3,90,3
000300e2,200485,200705,14,2,220,3
0001365f,200625,200735,1,0,110,3
0003ced2,200435,200775,6,2,340,3
00010b46,200735,200865,5,0,130,3
00022ba5,200585,200905,8,1,320,3
00024b66,200895,200965,2,1,70,3
00024205,200665,201005,5,1,340,3
0004ca6b,200845,201005,13,3,160,3
0002ef2f,200975,201065,1,1,90,3
000402b3,200555,201105,7,3,550,3
0001ac3b,200825,201195,9,0,370,3
00023b5b,300396,300515,3,1,119,3
00023b77,300435,300705,10,1,270,3
0004b35a,400585,400625,3,3,40,3
00019ef6,400675,400895,13,0,220,3
0001c3a1,400795,400935,5,0,140,3
000330f9,400785,400975,14,2,190,3
00020f7e,400875,401025,4,1,150,3
0003f610,400765,401065,11,2,300,3
00027a8b,400865,401135,9,1,270,3
0001c32c,400995,401285,12,0,290,3
00031aa5,400985,401315,11,2,330,3
0004a0e0,400875,401315,15,3,440,3
00022fcb,400945,401375,10,1,430,3
0001972f,175,415,13,0,240,15
0001972f,175,415,13,0,240,15
0001452a,100215,100255,0,0,40,15
0003ebb5,100215,100515,11,2,300,15
000114df,100225,100545,10,0,320,15
0003515d,100435,100595,14,2,160,15
00016d7e,100385,100695,6,0,310,15
00048da8,100645,100765,12,3,120,15
00019d38,100555,100795,5,0,240,15
00046bbc,100315,100805,11,3,490,15
0001881d,100795,100855,0,0,60,15
0001ca19,100255,100895,11,0,640,15
0001f5f6,100465,100935,6,0,470,15
00043a57,100935,101045,2,3,110,15
00021e31,101015,101125,0,1,110,15
0004fc5a,100665,101125,14,3,460,15
0002b448,100695,101185,13,1,490,15
00048c76,100855,101225,15,3,370,15
000170df,100725,101285,15,0,560,15
0002d3fb,100415,101285,11,1,870,15
00045063,100975,101425,6,3,450,15
00015a3b,100775,101445,15,0,670,15
00019297,101105,101575,13,0,470,15
00024bee,101245,101595,8,1,350,15
000429ca,101165,101625,8,3,460,15
0002d8ca,101165,101665,11,1,500,15
0003319a,101365,101695,10,2,330,15
0004a6be,101375,101785,7,3,410,15
00017fbc,101315,101805,10,0,490,15
0001972f,175,415,13,0,240,15
0001452a,100215,100255,0,0,40,15
0003ebb5,100215,100515,11,2,300,15
000114df,100225,100545,10,0,320,15
0003515d,100435,100595,14,2,160,15
00016d7e,100385,100695,6,0,310,15
00048da8,100645,100765,12,3,120,15
00019d38,100555,100795,5,0,240,15
00046bbc,100315,100805,11,3,490,15
0001881d,100795,100855,0,0,60,15
0001ca19,100255,100895,11,0,640,15
0001f5f6,100465,100935,6,0,470,15
00043a57,100935,101045,2,3,110,15
00021e31,101015,101125,0,1,110,15
0004fc5a,100665,101125,14,3,460,15
0002b448,100695,101185,13,1,490,15
00048c76,100855,101225,15,3,370,15
000170df,100725,101285,15,0,560,15
0002d3fb,100415,101285,11,1,870,15
00045063,100975,101425,6,3,450,15
00015a3b,100775,101445,15,0,670,15
00019297,101105,101575,13,0,470,15
00024bee,101245,101595,8,1,350,15
000429ca,101165,101625,8,3,460,15
0002d8ca,101165,101665,11,1,500,15
0003319a,101365,101695,10,2,330,15
0004a6be,101375,101785,7,3,410,15
00017fbc,101315,101805,10,0,490,15
0001f1e0,200375,200495,2,0,120,15
0003605d,200445,200525,12,2,80,15
000352a4,200525,200695,4,2,170,15
0004cb3f,200695,200785,2,3,90,15
00030b68,200425,200805,6,2,380,15
0002514c,200595,200905,14,1,310,15
0002f19c,200735,200945,4,1,210,15
0004098f,200445,200965,6,3,520,15
00039c83,200855,200975,3,2,120,15
0002a5df,200615,201045,7,1,430,15
000383be,201005,201095,2,2,90,15
000124a6,200705,201105,7,0,400,15
00044597,200635,201185,8,3,550,15
00013d66,200935,201205,5,0,270,15
00015021,200765,201305,7,0,540,15
000413a1,201005,201305,1,3,300,15
0002d226,201025,201335,14,1,310,15
0001e5b6,201105,201405,6,0,300,15
0001bc7a,201125,201505,8,0,380,15
00043de5,201235,201525,5,3,290,15
00038b84,201165,201705,7,2,540,15
00042592,201305,201835,7,3,530,15
0001a648,201465,201875,10,0,410,15
00049d67,201585,201875,0,3,290,15
0001c54d,201625,201935,7,0,310,15
0003a783,201395,201955,7,2,560,15
00017f8d,201775,202095,6,0,320,15
0001ffcb,201705,202175,15,0,470,15
00012aad,201545,202215,11,0,670,15
0001972f,175,415,13,0,240,15
0001452a,100215,100255,0,0,40,15
0003ebb5,100215,100515,11,2,300,15
000114df,100225,100545,10,0,320,15
0003515d,100435,100595,14,2,160,15
00016d7e,100385,100695,6,0,310,15
00048da8,100645,100765,12,3,120,15
00019d38,100555,100795,5,0,240,15
00046bbc,100315,100805,11,3,490,15
0001881d,100795,100855,0,0,60,15
0001ca19,100255,100895,11,0,640,15
0001f5f6,100465,100935,6,0,470,15
00043a57,100935,101045,2,3,110,15
00021e31,101015,101125,0,1,110,15
0004fc5a,100665,101125,14,3,460,15
0002b448,100695,101185,13,1,490,15
00048c76,100855,101225,15,3,370,15
000170df,100725,101285,15,0,560,15
0002d3fb,100415,101285,11,1,870,15
00045063,100975,101425,6,3,450,15
00015a3b,100775,101445,15,0,670,15
00019297,101105,101575,13,0,470,15
00024bee,101245,101595,8,1,350,15
000429ca,101165,101625,8,3,460,15
0002d8ca,101165,101665,11,1,500,15
0003319a,101365,101695,10,2,330,15
0004a6be,101375,101785,7,3,410,15
00017fbc,101315,101805,10,0,490,15
0001f1e0,200375,200495,2,0,120,15
0003605d,200445,200525,12,2,80,15
000352a4,200525,200695,4,2,170,15
0004cb3f,200695,200785,2,3,90,15
00030b68,200425,200805,6,2,380,15
0002514c,200595,200905,14,1,310,15
0002f19c,200735,200945,4,1,210,15
0004098f,200445,200965,6,3,520,15
00039c83,200855,200975,3,2,120,15
0002a5df,200615,201045,7,1,430,15
000383be,201005,201095,2,2,90,15
000124a6,200705,201105,7,0,400,15
00044597,200635,201185,8,3,550,15
00013d66,200935,201205,5,0,270,15
00015021,200765,201305,7,0,540,15
000413a1,201005,201305,1,3,300,15
0002d226,201025,201335,14,1,310,15
0001e5b6,201105,201405,6,0,300,15
0001bc7a,201125,201505,8,0,380,15
00043de5,201235,201525,5,3,290,15
00038b84,201165,201705,7,2,540,15
00042592,201305,201835,7,3,530,15
0001a648,201465,201875,10,0,410,15
00049d67,201585,201875,0,3,290,15
0001c54d,201625,201935,7,0,310,15
0003a783,201395,201955,7,2,560,15
00017f8d,201775,202095,6,0,320,15
0001ffcb,201705,202175,15,0,470,15
00012aad,201545,202215,11,0,670,15
0004b67f,300445,300625,14,3,180,15
000337e4,300435,300695,4,2,260,15
0002bba7,300485,300725,4,1,240,15
0004a947,300555,300855,10,3,300,15
0004ef7b,300595,300955,0,3,360,15
00017457,300695,300985,6,0,290,15
00039206,300595,301015,8,2,420,15
0004c8ac,300605,301355,8,3,750,15
0001972f,175,415,13,0,240,15
0001452a,100215,100255,0,0,40,15
0003ebb5,100215,100515,11,2,300,15
000114df,100225,100545,10,0,320,15
0003515d,100435,100595,14,2,160,15
00016d7e,100385,100695,6,0,310,15
00048da8,100645,100765,12,3,120,15
00019d38,100555,100795,5,0,240,15
00046bbc,100315,100805,11,3,490,15
0001881d,100795,100855,0,0,60,15
0001ca19,100255,100895,11,0,640,15
0001f5f6,100465,100935,6,0,470,15
00043a57,100935,101045,2,3,110,15
00021e31,101015,101125,0,1,110,15
0004fc5a,100665,101125,14,3,460,15
0002b448,100695,101185,13,1,490,15
00048c76,100855,101225,15,3,370,15
000170df,100725,101285,15,0,560,15
0002d3fb,100415,101285,11,1,870,15
00045063,100975,101425,6,3,450,15
00015a3b,100775,101445,15,0,670,15
00019297,101105,101575,13,0,470,15
00024bee,101245,101595,8,1,350,15
000429ca,101165,101625,8,3,460,15
0002d8ca,101165,101665,11,1,500,15
0003319a,101365,101695,10,2,330,15
0004a6be,101375,101785,7,3,410,15
00017fbc,101315,101805,10,0,490,15
0001f1e0,200375,200495,2,0,120,15
0003605d,200445,200525,12,2,80,15
000352a4,200525,200695,4,2,170,15
0004cb3f,200695,200785,2,3,90,15
00030b68,200425,200805,6,2,380,15
0002514c,200595,200905,14,1,310,15
0002f19c,200735,200945,4,1,210,15
0004098f,200445,200965,6,3,520,15
00039c83,200855,200975,3,2,120,15
0002a5df,200615,201045,7,1,430,15
000383be,201005,201095,2,2,90,15
000124a6,200705,201105,7,0,400,15
00044597,200635,201185,8,3,550,15
00013d66,200935,201205,5,0,270,15
00015021,200765,201305,7,0,540,15
000413a1,201005,201305,1,3,300,15
0002d226,201025,201335,14,1,310,15
0001e5b6,201105,201405,6,0,300,15
0001bc7a,201125,201505,8,0,380,15
00043de5,201235,201525,5,3,290,15
00038b84,201165,201705,7,2,540,15
00042592,201305,201835,7,3,530,15
0001a648,201465,201875,10,0,410,15
00049d67,201585,201875,0,3,290,15
0001c54d,201625,201935,7,0,310,15
0003a783,201395,201955,7,2,560,15
00017f8d,201775,202095,6,0,320,15
0001ffcb,201705,202175,15,0,470,15
00012aad,201545,202215,11,0,670,15
0004b67f,300445,300625,14,3,180,15
000337e4,300435,300695,4,2,260,15
0002bba7,300485,300725,4,1,240,15
0004a947,300555,300855,10,3,300,15
0004ef7b,300595,300955,0,3,360,15
00017457,300695,300985,6,0,290,15
00039206,300595,301015,8,2,420,15
0004c8ac,300605,301355,8,3,750,15
00030bfd,400545,400625,3,2,80,15
0001e413,400645,400795,5,0,150,15
00049594,400595,400885,10,3,290,15
000371b0,400725,400945,4,2,220,15
0004ccac,400835,400945,12,3,110,15
0004ee14,400755,400985,15,3,230,15
00026aaa,400895,401025,0,1,130,15
00047da3,400985,401075,12,3,90,15
000403d2,400995,401115,13,3,120,15
0002ffd3,400815,401165,7,1,350,15
00045fea,401155,401235,2,3,80,15
0002712c,401035,401265,4,1,230,15
0001dbd0,401215,401415,6,0,200,15
00020b03,401285,401415,2,1,130,15
0003153a,401095,401425,14,2,330,15
0003d660,401485,401555,3,2,70,15
000241ae,401435,401595,2,1,160,15
000342ae,401255,401595,15,2,340,15
000408c6,401375,401625,9,3,250,15
000322d0,401385,401775,6,2,390,15
000271cf,401575,401785,3,1,210,15
0003ca41,401575,401815,0,2,240,15
00042551,165,565,5,3,400,11
00042551,165,565,5,3,400,11
000228d5,100335,100535,13,1,200,11
00033643,100285,100535,10,2,250,11
00042551,165,565,5,3,400,11
000228d5,100335,100535,13,1,200,11
00033643,100285,100535,10,2,250,11
00040c64,200405,200445,3,3,40,11
000125e6,200385,200545,5,0,160,11
0002cdde,200485,200565,2,1,80,11
00032af9,200335,200655,9,2,320,11
0001ad09,200385,200675,8,0,290,11
0003b33c,200445,200755,11,2,310,11
00047eb1,200575,200925,15,3,350,11
00042551,165,565,5,3,400,11
000228d5,100335,100535,13,1,200,11
00033643,100285,100535,10,2,250,11
00040c64,200405,200445,3,3,40,11
000125e6,200385,200545,5,0,160,11
0002cdde,200485,200565,2,1,80,11
00032af9,200335,200655,9,2,320,11
0001ad09,200385,200675,8,0,290,11
0003b33c,200445,200755,11,2,310,11
00047eb1,200575,200925,15,3,350,11
00045254,300435,300475,3,3,40,11
00042551,165,565,5,3,400,11
000228d5,100335,100535,13,1,200,11
00033643,100285,100535,10,2,250,11
00040c64,200405,200445,3,3,40,11
000125e6,200385,200545,5,0,160,11
0002cdde,200485,200565,2,1,80,11
00032af9,200335,200655,9,2,320,11
0001ad09,200385,200675,8,0,290,11
0003b33c,200445,200755,11,2,310,11
00047eb1,200575,200925,15,3,350,11
00045254,300435,300475,3,3,40,11
0003872b,400545,400745,0,2,200,11
00032bf8,400725,400865,1,2,140,11
0002f70c,400575,400875,8,1,300,11
0004d228,400785,401135,10,3,350,11
0002ef87,400675,401185,8,1,510,11
00041a57,400915,401275,9,3,360,11
0004a9e2,400665,401315,7,3,650,11
00039c9b,400865,401375,7,2,510,11
0002f409,400955,401395,8,1,440,11
0002b278,401065,401525,11,1,460,11
00046a47,400995,401545,7,3,550,11
0003411b,115,235,1,2,120,8
0003411b,115,235,1,2,120,8
00048429,100265,100325,12,3,60,8
000279f6,100295,100485,13,1,190,8
00048767,100385,100545,1,3,160,8
0003d93c,100555,100645,12,2,90,8
0002229c,100415,100675,14,1,260,8
00036b1a,100455,100685,9,2,230,8
0004ba1a,100675,100755,12,3,80,8
00043ea3,100335,100795,10,3,460,8
000423e1,100525,100835,0,3,310,8
0002d5c9,100435,100855,14,1,420,8
0003d4a4,100745,100865,2,2,120,8
000255a1,100845,100935,1,1,90,8
000337ef,100635,100975,15,2,340,8
0002efa2,100645,100995,7,1,350,8
00026e54,100705,101075,10,1,370,8
00020c6f,100775,101245,8,1,470,8
0004fbaa,101075,101245,5,3,170,8
00017061,100995,101345,9,0,350,8
00028902,100915,101345,11,1,430,8
000326c8,100975,101415,8,2,440,8
00047d81,101155,101425,4,3,270,8
00034819,101175,101495,6,2,320,8
0004cf91,101075,101625,0,3,550,8
0003411b,115,235,1,2,120,8
00048429,100265,100325,12,3,60,8
000279f6,100295,100485,13,1,190,8
00048767,100385,100545,1,3,160,8
0003d93c,100555,100645,12,2,90,8
0002229c,100415,100675,14,1,260,8
00036b1a,100455,100685,9,2,230,8
0004ba1a,100675,100755,12,3,80,8
00043ea3,100335,100795,10,3,460,8
000423e1,100525,100835,0,3,310,8
0002d5c9,100435,100855,14,1,420,8
0003d4a4,100745,100865,2,2,120,8
000255a1,100845,100935,1,1,90,8
000337ef,100635,100975,15,2,340,8
0002efa2,100645,100995,7,1,350,8
00026e54,100705,101075,10,1,370,8
00020c6f,100775,101245,8,1,470,8
0004fbaa,101075,101245,5,3,170,8
00017061,100995,101345,9,0,350,8
00028902,100915,101345,11,1,430,8
000326c8,100975,101415,8,2,440,8
00047d81,101155,101425,4,3,270,8
00034819,101175,101495,6,2,320,8
0004cf91,101075,101625,0,3,550,8
0003ad66,200405,200505,12,2,100,8
000156a3,200395,200635,13,0,240,8
00020204,200325,200655,7,1,330,8
00018b24,200495,200735,6,0,240,8
00025301,200515,200775,12,1,260,8
0003411b,115,235,1,2,120,8
00048429,100265,100325,12,3,60,8
000279f6,100295,100485,13,1,190,8
00048767,100385,100545,1,3,160,8
0003d93c,100555,100645,12,2,90,8
0002229c,100415,100675,14,1,260,8
00036b1a,100455,100685,9,2,230,8
0004ba1a,100675,100755,12,3,80,8
00043ea3,100335,100795,10,3,460,8
000423e1,100525,100835,0,3,310,8
0002d5c9,100435,100855,14,1,420,8
0003d4a4,100745,100865,2,2,120,8
000255a1,100845,100935,1,1,90,8
000337ef,100635,100975,15,2,340,8
0002efa2,100645,100995,7,1,350,8
00026e54,100705,101075,10,1,370,8
00020c6f,100775,101245,8,1,470,8
0004fbaa,101075,101245,5,3,170,8
00017061,100995,101345,9,0,350,8
00028902,100915,101345,11,1,430,8
000326c8,100975,101415,8,2,440,8
00047d81,101155,101425,4,3,270,8
00034819,101175,101495,6,2,320,8
0004cf91,101075,101625,0,3,550,8
0003ad66,200405,200505,12,2,100,8
000156a3,200395,200635,13,0,240,8
00020204,200325,200655,7,1,330,8
00018b24,200495,200735,6,0,240,8
00025301,200515,200775,12,1,260,8
00031d55,200585,200975,8,2,390,8
00016fa9,200665,201015,3,0,350,8
00046a62,200815,201075,0,3,260,8
00024702,200765,201145,10,1,380,8
0003b987,200915,201155,4,2,240,8
00011b04,200745,201165,9,0,420,8
0002634a,201095,201265,2,1,170,8
000429ab,200885,201275,7,3,390,8
00034ef7,201005,201345,10,2,340,8
0004e041,200945,201435,7,3,490,8
0002601a,201185,201515,9,1,330,8
00022531,201355,201555,0,1,200,8
0001fb93,201305,201615,7,0,310,8
0002de34,201055,201655,8,1,600,8
0002ee29,201275,201715,10,1,440,8
0004ce29,201465,201715,14,3,250,8
00010e71,201275,201825,15,0,550,8
00040d86,201375,201835,0,3,460,8
000281cb,300435,300575,12,1,140,8
00042396,300435,300575,14,3,140,8
00019475,300485,300645,5,0,160,8
0003411b,115,235,1,2,120,8
00048429,100265,100325,12,3,60,8
000279f6,100295,100485,13,1,190,8
00048767,100385,100545,1,3,160,8
0003d93c,100555,100645,12,2,90,8
0002229c,100415,100675,14,1,260,8
00036b1a,100455,100685,9,2,230,8
0004ba1a,100675,100755,12,3,80,8
00043ea3,100335,100795,10,3,460,8
000423e1,100525,100835,0,3,310,8
0002d5c9,100435,100855,14,1,420,8
0003d4a4,100745,100865,2,2,120,8
000255a1,100845,100935,1,1,90,8
000337ef,100635,100975,15,2,340,8
0002efa2,100645,100995,7,1,350,8
00026e54,100705,101075,10,1,370,8
00020c6f,100775,101245,8,1,470,8
0004fbaa,101075,101245,5,3,170,8
00017061,100995,101345,9,0,350,8
00028902,100915,101345,11,1,430,8
000326c8,100975,101415,8,2,440,8
00047d81,101155,101425,4,3,270,8
00034819,101175,101495,6,2,320,8
0004cf91,101075,101625,0,3,550,8
0003ad66,200405,200505,12,2,100,8
000156a3,200395,200635,13,0,240,8
00020204,200325,200655,7,1,330,8
00018b24,200495,200735,6,0,240,8
00025301,200515,200775,12,1,260,8
00031d55,200585,200975,8,2,390,8
00016fa9,200665,201015,3,0,350,8
00046a62,200815,201075,0,3,260,8
00024702,200765,201145,10,1,380,8
0003b987,200915,201155,4,2,240,8
00011b04,200745,201165,9,0,420,8
0002634a,201095,201265,2,1,170,8
000429ab,200885,201275,7,3,390,8
00034ef7,201005,201345,10,2,340,8
0004e041,200945,201435,7,3,490,8
0002601a,201185,201515,9,1,330,8
00022531,201355,201555,0,1,200,8
0001fb93,201305,201615,7,0,310,8
0002de34,201055,201655,8,1,600,8
0002ee29,201275,201715,10,1,440,8
0004ce29,201465,201715,14,3,250,8
00010e71,201275,201825,15,0,550,8
00040d86,201375,201835,0,3,460,8
000281cb,300435,300575,12,1,140,8
00042396,300435,300575,14,3,140,8
00019475,300485,300645,5,0,160,8
0002ba7b,400575,400695,3,1,120,8
00035ada,400775,400835,0,2,60,8
00035ada,400775,400955,0,2,180,8
0001a272,400705,400985,5,0,280,8
00036126,400745,401055,11,2,310,8
0001e4f9,400935,401065,2,0,130,8
000438d1,400965,401065,12,3,100,8
000136a0,400645,401105,10,0,460,8
00024df0,400835,401135,10,1,300,8
00048662,400695,401135,5,3,440,8
0001217d,401055,401145,4,0,90,8
0001e4f9,400935,401205,2,0,270,8
000321d4,400835,401215,9,2,380,8
00046cb9,400905,401275,9,3,370,8
0003c6ad,400885,401295,5,2,410,8
00025eac,401005,401325,13,1,320,8
00015eb7,401005,401365,6,0,360,8
00029b50,401175,401365,0,1,190,8
00013b6b,401375,401435,0,0,60,8
00031589,401105,401485,6,2,380,8
00013d45,401115,401495,6,0,380,8
0003fa67,401085,401525,9,2,440,8
0004e243,401195,401535,15,3,340,8
000201ab,401285,401605,8,1,320,8
0003bc37,401515,401665,12,2,150,8
00043044,401445,401685,11,3,240,8
00029cd6,401615,401715,0,1,100,8
00018942,401705,401935,7,0,230,8
00033915,401555,402035,8,2,480,8
0002f336,401665,402105,6,1,440,8
000150a0,401755,402185,14,0,430,8
00022af4,401715,402185,10,1,470,8
00033e1f,145,225,3,2,80,3
00033e1f,145,225,3,2,80,3
00040323,100245,100665,5,3,420,3
00015919,100475,100725,3,0,250,3
0002e5f7,100425,100755,13,1,330,3
0004ef7f,100335,100785,15,3,450,3
00048064,100295,100825,6,3,530,3
0001e3f9,100645,100955,12,0,310,3
0003d169,100725,100955,3,2,230,3
000383ac,100825,101015,4,2,190,3
0004eb40,100475,101045,15,3,570,3
0001c232,100825,101095,2,0,270,3
0002312d,100885,101105,5,1,220,3
000266c9,100905,101225,9,1,320,3
00029b84,100985,101265,8,1,280,3
000434f2,100765,101285,5,3,520,3
0001d635,100405,101295,15,0,890,3
00021768,100745,101325,3,1,580,3
00018c40,101055,101335,6,0,280,3
0003b25e,100775,101375,11,2,600,3
000405c5,101015,101385,13,3,370,3
0002f413,101265,101485,5,1,220,3
00034a12,101095,101495,7,2,400,3
000138f0,100825,101515,3,0,690,3
00027a61,101185,101545,3,1,360,3
00012fdc,101005,101555,8,0,550,3
00033e1f,145,225,3,2,80,3
00040323,100245,100665,5,3,420,3
00015919,100475,100725,3,0,250,3
0002e5f7,100425,100755,13,1,330,3
0004ef7f,100335,100785,15,3,450,3
00048064,100295,100825,6,3,530,3
0001e3f9,100645,100955,12,0,310,3
0003d169,100725,100955,3,2,230,3
000383ac,100825,101015,4,2,190,3
0004eb40,100475,101045,15,3,570,3
0001c232,100825,101095,2,0,270,3
0002312d,100885,101105,5,1,220,3
000266c9,100905,101225,9,1,320,3
00029b84,100985,101265,8,1,280,3
000434f2,100765,101285,5,3,520,3
0001d635,100405,101295,15,0,890,3
00021768,100745,101325,3,1,580,3
00018c40,101055,101335,6,0,280,3
0003b25e,100775,101375,11,2,600,3
000405c5,101015,101385,13,3,370,3
0002f413,101265,101485,5,1,220,3
00034a12,101095,101495,7,2,400,3
000138f0,100825,101515,3,0,690,3
00027a61,101185,101545,3,1,360,3
00012fdc,101005,101555,8,0,550,3
0002500b,200365,200545,4,1,180,3
0004704e,200425,200545,13,3,120,3
00011a47,200355,200575,6,0,220,3
000343a6,200535,200725,1,2,190,3
00027392,200455,200745,14,1,290,3
00028bd6,200725,200785,0,1,60,3
0001ccd5,200315,200795,11,0,480,3
00025516,200625,200845,3,1,220,3
0002f2f2,200475,200925,15,1,450,3
0002ad1e,200895,201005,2,1,110,3
0003e63b,200585,201005,11,2,420,3
00040175,200625,201015,11,3,390,3
0002b313,200725,201065,4,1,340,3
000146ba,200805,201105,13,0,300,3
00025d36,201065,201105,1,1,40,3
0002d345,200655,201185,6,1,530,3
0003b309,200985,201255,13,2,270,3
00030a4d,201195,201315,1,2,120,3
00033f0e,201145,201375,7,2,230,3
0003625b,200945,201415,0,2,470,3
0004b9f3,201175,201455,15,3,280,3
00016597,201065,201465,10,0,400,3
0002206b,201175,201565,15,1,390,3
0001ee5e,200985,201595,14,0,610,3
00033e1f,145,225,3,2,80,3
00040323,100245,100665,5,3,420,3
00015919,100475,100725,3,0,250,3
0002e5f7,100425,100755,13,1,330,3
0004ef7f,100335,100785,15,3,450,3
00048064,100295,100825,6,3,530,3
0001e3f9,100645,100955,12,0,310,3
0003d169,100725,100955,3,2,230,3
000383ac,100825,101015,4,2,190,3
0004eb40,100475,101045,15,3,570,3
0001c232,100825,101095,2,0,270,3
0002312d,100885,101105,5,1,220,3
000266c9,100905,101225,9,1,320,3
00029b84,100985,101265,8,1,280,3
000434f2,100765,101285,5,3,520,3
0001d635,100405,101295,15,0,890,3
00021768,100745,101325,3,1,580,3
00018c40,101055,101335,6,0,280,3
0003b25e,100775,101375,11,2,600,3
000405c5,101015,101385,13,3,370,3
0002f413,101265,101485,5,1,220,3
00034a12,101095,101495,7,2,400,3
000138f0,100825,101515,3,0,690,3
00027a61,101185,101545,3,1,360,3
00012fdc,101005,101555,8,0,550,3
0002500b,200365,200545,4,1,180,3
0004704e,200425,200545,13,3,120,3
00011a47,200355,200575,6,0,220,3
000343a6,200535,200725,1,2,190,3
00027392,200455,200745,14,1,290,3
00028bd6,200725,200785,0,1,60,3
0001ccd5,200315,200795,11,0,480,3
00025516,200625,200845,3,1,220,3
0002f2f2,200475,200925,15,1,450,3
0002ad1e,200895,201005,2,1,110,3
0003e63b,200585,201005,11,2,420,3
00040175,200625,201015,11,3,390,3
0002b313,200725,201065,4,1,340,3
000146ba,200805,201105,13,0,300,3
00025d36,201065,201105,1,1,40,3
0002d345,200655,201185,6,1,530,3
0003b309,200985,201255,13,2,270,3
00030a4d,201195,201315,1,2,120,3
00033f0e,201145,201375,7,2,230,3
0003625b,200945,201415,0,2,470,3
0004b9f3,201175,201455,15,3,280,3
00016597,201065,201465,10,0,400,3
0002206b,201175,201565,15,1,390,3
0001ee5e,200985,201595,14,0,610,3
0003ee1d,300405,300605,0,2,200,3
0001b88c,300455,300835,11,0,380,3
00033e1f,145,225,3,2,80,3
00040323,100245,100665,5,3,420,3
00015919,100475,100725,3,0,250,3
0002e5f7,100425,100755,13,1,330,3
0004ef7f,100335,100785,15,3,450,3
00048064,100295,100825,6,3,530,3
0001e3f9,100645,100955,12,0,310,3
0003d169,100725,100955,3,2,230,3
000383ac,100825,101015,4,2,190,3
0004eb40,100475,101045,15,3,570,3
0001c232,100825,101095,2,0,270,3
0002312d,100885,101105,5,1,220,3
000266c9,100905,101225,9,1,320,3
00029b84,100985,101265,8,1,280,3
000434f2,100765,101285,5,3,520,3
0001d635,100405,101295,15,0,890,3
00021768,100745,101325,3,1,580,3
00018c40,101055,101335,6,0,280,3
0003b25e,100775,101375,11,2,600,3
000405c5,101015,101385,13,3,370,3
0002f413,101265,101485,5,1,220,3
00034a12,101095,101495,7,2,400,3
000138f0,100825,101515,3,0,690,3
00027a61,101185,101545,3,1,360,3
00012fdc,101005,101555,8,0,550,3
0002500b,200365,200545,4,1,180,3
0004704e,200425,200545,13,3,120,3
00011a47,200355,200575,6,0,220,3
000343a6,200535,200725,1,2,190,3
00027392,200455,200745,14,1,290,3
00028bd6,200725,200785,0,1,60,3
0001ccd5,200315,200795,11,0,480,3
00025516,200625,200845,3,1,220,3
0002f2f2,200475,200925,15,1,450,3
0002ad1e,200895,201005,2,1,110,3
0003e63b,200585,201005,11,2,420,3
00040175,200625,201015,11,3,390,3
0002b313,200725,201065,4,1,340,3
000146ba,200805,201105,13,0,300,3
00025d36,201065,201105,1,1,40,3
0002d345,200655,201185,6,1,530,3
0003b309,200985,201255,13,2,270,3
00030a4d,201195,201315,1,2,120,3
00033f0e,201145,201375,7,2,230,3
0003625b,200945,201415,0,2,470,3
0004b9f3,201175,201455,15,3,280,3
00016597,201065,201465,10,0,400,3
0002206b,201175,201565,15,1,390,3
0001ee5e,200985,201595,14,0,610,3
0003ee1d,300405,300605,0,2,200,3
0001b88c,300455,300835,11,0,380,3
0004f7f2,400535,400595,12,3,60,3
00024982,400685,400725,1,1,40,3
0003f952,400775,400815,2,2,40,3
0004174d,400735,400815,3,3,80,3
0002d334,400595,400875,6,1,280,3
0001ef56,400825,400965,5,0,140,3
00024ce4,400715,401045,11,1,330,3
0001f0f0,400895,401095,6,0,200,3
0003145e,400905,401125,0,2,220,3
00017e1a,401035,401165,1,0,130,3
00014275,400915,401205,9,0,290,3
0001abec,400845,401285,11,0,440,3
0003771e,401095,401345,4,2,250,3
0002ea2f,400965,401415,8,1,450,3
00039e73,401035,401455,11,2,420,3
000475e9,401015,401505,8,3,490,3
00020b1f,96,235,12,1,139,8
00020b1f,96,235,12,1,139,8
000248d4,100225,100425,13,1,200,8
0003e1e5,100325,100445,1,2,120,8
00035a66,100255,100625,5,2,370,8
0004b6fe,100245,100625,6,3,380,8
00020b1f,96,235,12,1,139,8
000248d4,100225,100425,13,1,200,8
0003e1e5,100325,100445,1,2,120,8
00035a66,100255,100625,5,2,370,8
0004b6fe,100245,100625,6,3,380,8
0002ecc3,200385,200425,1,1,40,8
0003c673,200525,200625,12,2,100,8
00043fca,200425,200715,0,3,290,8
0002b6e2,200555,200765,5,1,210,8
0003686f,200385,200795,7,2,410,8
0002b121,200435,200825,11,1,390,8
00020b1f,96,235,12,1,139,8
000248d4,100225,100425,13,1,200,8
0003e1e5,100325,100445,1,2,120,8
00035a66,100255,100625,5,2,370,8
0004b6fe,100245,100625,6,3,380,8
0002ecc3,200385,200425,1,1,40,8
0003c673,200525,200625,12,2,100,8
00043fca,200425,200715,0,3,290,8
0002b6e2,200555,200765,5,1,210,8
0003686f,200385,200795,7,2,410,8
0002b121,200435,200825,11,1,390,8
000319b2,300445,300565,1,2,120,8
000281a4,300535,300775,9,1,240,8
0003f80b,300635,300785,13,2,150,8
00027a07,300695,300855,2,1,160,8
0002e937,300555,301035,11,1,480,8
00010ca0,300775,301055,7,0,280,8
0002ee65,300795,301105,9,1,310,8
00020b1f,96,235,12,1,139,8
000248d4,100225,100425,13,1,200,8
0003e1e5,100325,100445,1,2,120,8
00035a66,100255,100625,5,2,370,8
0004b6fe,100245,100625,6,3,380,8
0002ecc3,200385,200425,1,1,40,8
0003c673,200525,200625,12,2,100,8
00043fca,200425,200715,0,3,290,8
0002b6e2,200555,200765,5,1,210,8
0003686f,200385,200795,7,2,410,8
0002b121,200435,200825,11,1,390,8
000319b2,300445,300565,1,2,120,8
000281a4,300535,300775,9,1,240,8
0003f80b,300635,300785,13,2,150,8
00027a07,300695,300855,2,1,160,8
0002e937,300555,301035,11,1,480,8
00010ca0,300775,301055,7,0,280,8
0002ee65,300795,301105,9,1,310,8
0002be69,400575,400755,13,1,180,8
0004f369,400665,400875,1,3,210,8
0001adc7,400605,401015,11,0,410,8
00039e11,400855,401045,13,2,190,8
00039e11,400855,401125,13,2,270,8
0004ae03,400915,401175,11,3,260,8
0004b1f3,400785,401215,7,3,430,8
00034471,401045,401265,12,2,220,8
00013381,400955,401275,8,0,320,8
0003ea44,401115,401325,4,2,210,8
00049bbe,401195,401335,2,3,140,8
00028cbe,401285,401415,2,1,130,8
000253c5,401075,401515,12,1,440,8
00027e49,401375,401555,5,1,180,8
00046167,401035,401575,8,3,540,8
0004682f,401505,401675,4,3,170,8
0003d243,401565,401905,5,2,340,8
000470fd,401415,401945,7,3,530,8
0001c87d,401475,401965,15,0,490,8
00025c13,401625,402035,8,1,410,8
00039b21,401505,402045,7,2,540,8
0002686f,115,195,2,1,80,12
0002686f,115,195,2,1,80,12
000363c6,100345,100385,2,2,40,12
00010886,100255,100475,6,0,220,12
0003e562,100425,100685,10,2,260,12
0001b1ca,100595,100745,3,0,150,12
0003e7e8,100495,100765,14,2,270,12
000140b3,100505,100805,9,0,300,12
00039fd6,100655,100825,0,2,170,12
0002f87c,100765,100905,12,1,140,12
0003cc73,100745,100945,1,2,200,12
00046313,100855,101065,5,3,210,12
00017646,100905,101215,12,0,310,12
00032e76,100945,101215,6,2,270,12
0004e82a,100805,101285,7,3,480,12
0002686f,115,195,2,1,80,12
000363c6,100345,100385,2,2,40,12
00010886,100255,100475,6,0,220,12
0003e562,100425,100685,10,2,260,12
0001b1ca,100595,100745,3,0,150,12
0003e7e8,100495,100765,14,2,270,12
000140b3,100505,100805,9,0,300,12
00039fd6,100655,100825,0,2,170,12
0002f87c,100765,100905,12,1,140,12
0003cc73,100745,100945,1,2,200,12
00046313,100855,101065,5,3,210,12
00017646,100905,101215,12,0,310,12
00032e76,100945,101215,6,2,270,12
0004e82a,100805,101285,7,3,480,12
0003d5fe,200296,200455,13,2,159,12
0003212f,200375,200615,11,2,240,12
00010152,200365,200665,14,0,300,12
000437e9,200635,200735,2,3,100,12
000195a2,200585,200765,5,0,180,12
00021024,200525,200785,13,1,260,12
000286a2,200435,200885,8,1,450,12
000220b3,200585,200965,6,1,380,12
0002686f,115,195,2,1,80,12
000363c6,100345,100385,2,2,40,12
00010886,100255,100475,6,0,220,12
0003e562,100425,100685,10,2,260,12
0001b1ca,100595,100745,3,0,150,12
0003e7e8,100495,100765,14,2,270,12
000140b3,100505,100805,9,0,300,12
00039fd6,100655,100825,0,2,170,12
0002f87c,100765,100905,12,1,140,12
0003cc73,100745,100945,1,2,200,12
00046313,100855,101065,5,3,210,12
00017646,100905,101215,12,0,310,12
00032e76,100945,101215,6,2,270,12
0004e82a,100805,101285,7,3,480,12
0003d5fe,200296,200455,13,2,159,12
0003212f,200375,200615,11,2,240,12
00010152,200365,200665,14,0,300,12
000437e9,200635,200735,2,3,100,12
000195a2,200585,200765,5,0,180,12
00021024,200525,200785,13,1,260,12
000286a2,200435,200885,8,1,450,12
000220b3,200585,200965,6,1,380,12
000135a7,300625,300705,4,0,80,12
0001d177,300485,300765,13,0,280,12
00025601,300545,300765,13,1,220,12
0004a610,300645,300795,14,3,150,12
00027f75,300715,300855,4,1,140,12
000171fc,300695,300905,5,0,210,12
00011ddb,300665,300985,12,0,320,12
000386f9,300805,301005,10,2,200,12
0001659d,300825,301075,7,0,250,12
00020eb9,301085,301185,4,1,100,12
0001cbe7,301145,301285,1,0,140,12
0001b06f,301255,301325,4,0,70,12
00040177,301045,301365,10,3,320,12
0001abcc,301155,301385,12,0,230,12
0002d27c,300955,301415,10,1,460,12
00039e7d,300955,301505,8,2,550,12
00041eb2,301245,301605,11,3,360,12
0003e42b,300915,301705,7,2,790,12
0002686f,115,195,2,1,80,12
000363c6,100345,100385,2,2,40,12
00010886,100255,100475,6,0,220,12
0003e562,100425,100685,10,2,260,12
0001b1ca,100595,100745,3,0,150,12
0003e7e8,100495,100765,14,2,270,12
000140b3,100505,100805,9,0,300,12
00039fd6,100655,100825,0,2,170,12
0002f87c,100765,100905,12,1,140,12
0003cc73,100745,100945,1,2,200,12
00046313,100855,101065,5,3,210,12
00017646,100905,101215,12,0,310,12
00032e76,100945,101215,6,2,270,12
0004e82a,100805,101285,7,3,480,12
0003d5fe,200296,200455,13,2,159,12
0003212f,200375,200615,11,2,240,12
00010152,200365,200665,14,0,300,12
000437e9,200635,200735,2,3,100,12
000195a2,200585,200765,5,0,180,12
00021024,200525,200785,13,1,260,12
000286a2,200435,200885,8,1,450,12
000220b3,200585,200965,6,1,380,12
000135a7,300625,300705,4,0,80,12
0001d177,300485,300765,13,0,280,12
00025601,300545,300765,13,1,220,12
0004a610,300645,300795,14,3,150,12
00027f75,300715,300855,4,1,140,12
000171fc,300695,300905,5,0,210,12
00011ddb,300665,300985,12,0,320,12
000386f9,300805,301005,10,2,200,12
0001659d,300825,301075,7,0,250,12
00020eb9,301085,301185,4,1,100,12
0001cbe7,301145,301285,1,0,140,12
0001b06f,301255,301325,4,0,70,12
00040177,301045,301365,10,3,320,12
0001abcc,301155,301385,12,0,230,12
0002d27c,300955,301415,10,1,460,12
00039e7d,300955,301505,8,2,550,12
00041eb2,301245,301605,11,3,360,12
0003e42b,300915,301705,7,2,790,12
0004bc01,400505,400545,3,3,40,12
00036560,400545,400695,3,2,150,12
000472ec,400595,400715,13,3,120,12
0003ed5f,400585,400865,3,2,280,12
0002fc37,400715,400955,5,1,240,12
00010d30,400625,400985,7,0,360,12
000204ab,400885,400995,1,1,110,12
0004778d,400745,401025,11,3,280,12
0001dcec,400695,401085,14,0,390,12
000374b3,400935,401165,4,2,230,12
0001c683,400835,401185,9,0,350,12
00030a06,401005,401275,11,2,270,12
00011f24,401225,401295,4,0,70,12
00034724,401055,401435,15,2,380,12
0001df5c,401145,401445,7,0,300,12
0003c226,401325,401565,4,2,240,12
00042263,401075,401605,9,3,530,12
000210dc,401255,401615,11,1,360,12
0001d5e5,400925,401625,15,0,700,12
000287de,401235,401655,7,1,420,12
00032ff3,401355,401885,7,2,530,12
0003c6d5,401255,401925,7,2,670,12
00048c41,185,645,6,3,460,4
00048c41,185,645,6,3,460,4
000266d2,100255,100365,3,1,110,4
0002d5ec,100225,100425,4,1,200,4
00014ecd,100235,100525,6,0,290,4
00025020,100295,100525,4,1,230,4
0003164f,100445,100615,1,2,170,4
0002e82d,100385,100645,0,1,260,4
000295d4,100445,100725,9,1,280,4
0003b467,100585,100795,12,2,210,4
00026ead,100565,100805,3,1,240,4
0002424c,100515,100845,7,1,330,4
0003ae61,100485,100895,14,2,410,4
0004c277,100635,100945,14,3,310,4
0004b4eb,100705,100985,5,3,280,4
0003d177,100565,101035,15,2,470,4
000214de,100885,101045,2,1,160,4
000301b2,100815,101075,5,2,260,4
0003686f,100785,101155,3,2,370,4
00022955,100955,101305,14,1,350,4
0004eefb,101235,101305,12,3,70,4
0002c439,101025,101345,5,1,320,4
00043a03,101115,101365,0,3,250,4
0003227a,101275,101455,3,2,180,4
0001ad53,101185,101485,9,0,300,4
0001d08c,101415,101565,0,0,150,4
00031f07,101315,101605,7,2,290,4
00020be0,101335,101635,13,1,300,4
00048c41,185,645,6,3,460,4
000266d2,100255,100365,3,1,110,4
0002d5ec,100225,100425,4,1,200,4
00014ecd,100235,100525,6,0,290,4
00025020,100295,100525,4,1,230,4
0003164f,100445,100615,1,2,170,4
0002e82d,100385,100645,0,1,260,4
000295d4,100445,100725,9,1,280,4
0003b467,100585,100795,12,2,210,4
00026ead,100565,100805,3,1,240,4
0002424c,100515,100845,7,1,330,4
0003ae61,100485,100895,14,2,410,4
0004c277,100635,100945,14,3,310,4
0004b4eb,100705,100985,5,3,280,4
0003d177,100565,101035,15,2,470,4
000214de,100885,101045,2,1,160,4
000301b2,100815,101075,5,2,260,4
0003686f,100785,101155,3,2,370,4
00022955,100955,101305,14,1,350,4
0004eefb,101235,101305,12,3,70,4
0002c439,101025,101345,5,1,320,4
00043a03,101115,101365,0,3,250,4
0003227a,101275,101455,3,2,180,4
0001ad53,101185,101485,9,0,300,4
0001d08c,101415,101565,0,0,150,4
00031f07,101315,101605,7,2,290,4
00020be0,101335,101635,13,1,300,4
00035a99,200365,200465,12,2,100,4
0001ab50,200455,200535,1,0,80,4
000426aa,200605,200805,4,3,200,4
000251d3,200565,200865,6,1,300,4
0002c366,200535,200905,5,1,370,4
00016774,200675,201005,9,0,330,4
00048c41,185,645,6,3,460,4
000266d2,100255,100365,3,1,110,4
0002d5ec,100225,100425,4,1,200,4
00014ecd,100235,100525,6,0,290,4
00025020,100295,100525,4,1,230,4
0003164f,100445,100615,1,2,170,4
0002e82d,100385,100645,0,1,260,4
000295d4,100445,100725,9,1,280,4
0003b467,100585,100795,12,2,210,4
00026ead,100565,100805,3,1,240,4
0002424c,100515,100845,7,1,330,4
0003ae61,100485,100895,14,2,410,4
0004c277,100635,100945,14,3,310,4
0004b4eb,100705,100985,5,3,280,4
0003d177,100565,101035,15,2,470,4
000214de,100885,101045,2,1,160,4
000301b2,100815,101075,5,2,260,4
0003686f,100785,101155,3,2,370,4
00022955,100955,101305,14,1,350,4
0004eefb,101235,101305,12,3,70,4
0002c439,101025,101345,5,1,320,4
00043a03,101115,101365,0,3,250,4
0003227a,101275,101455,3,2,180,4
0001ad53,101185,101485,9,0,300,4
0001d08c,101415,101565,0,0,150,4
00031f07,101315,101605,7,2,290,4
00020be0,101335,101635,13,1,300,4
00035a99,200365,200465,12,2,100,4
0001ab50,200455,200535,1,0,80,4
000426aa,200605,200805,4,3,200,4
000251d3,200565,200865,6,1,300,4
0002c366,200535,200905,5,1,370,4
00016774,200675,201005,9,0,330,4
00031ecf,300515,300735,15,2,220,4
000229eb,300465,300755,14,1,290,4
0003995b,300495,300775,4,2,280,4
00048c41,185,645,6,3,460,4
000266d2,100255,100365,3,1,110,4
0002d5ec,100225,100425,4,1,200,4
00014ecd,100235,100525,6,0,290,4
00025020,100295,100525,4,1,230,4
0003164f,100445,100615,1,2,170,4
0002e82d,100385,100645,0,1,260,4
000295d4,100445,100725,9,1,280,4
0003b467,100585,100795,12,2,210,4
00026ead,100565,100805,3,1,240,4
0002424c,100515,100845,7,1,330,4
0003ae61,100485,100895,14,2,410,4
0004c277,100635,100945,14,3,310,4
0004b4eb,100705,100985,5,3,280,4
0003d177,100565,101035,15,2,470,4
000214de,100885,101045,2,1,160,4
000301b2,100815,101075,5,2,260,4
0003686f,100785,101155,3,2,370,4
00022955,100955,101305,14,1,350,4
0004eefb,101235,101305,12,3,70,4
0002c439,101025,101345,5,1,320,4
00043a03,101115,101365,0,3,250,4
0003227a,101275,101455,3,2,180,4
0001ad53,101185,101485,9,0,300,4
0001d08c,101415,101565,0,0,150,4
00031f07,101315,101605,7,2,290,4
00020be0,101335,101635,13,1,300,4
00035a99,200365,200465,12,2,100,4
0001ab50,200455,200535,1,0,80,4
000426aa,200605,200805,4,3,200,4
000251d3,200565,200865,6,1,300,4
0002c366,200535,200905,5,1,370,4
00016774,200675,201005,9,0,330,4
00031ecf,300515,300735,15,2,220,4
000229eb,300465,300755,14,1,290,4
0003995b,300495,300775,4,2,280,4
000169b4,400585,400725,1,0,140,4
0004ee18,400545,400825,0,3,280,4
00030767,400555,400875,10,2,320,4
00044b4a,400535,400905,9,3,370,4
0004fc90,400725,400945,1,3,220,4
00041f06,400875,401045,2,3,170,4
000311aa,400585,401095,10,2,510,4
0001da26,400935,401105,6,0,170,4
00047dc9,400765,401145,0,3,380,4
0001b566,401115,401165,4,0,50,4
0004112f,400635,401205,10,3,570,4
0004e62c,400805,401245,1,3,440,4
0001ed67,401245,401285,0,0,40,4
000341b2,400985,401285,5,2,300,4
0004fc13,401265,401395,2,3,130,4
00018f62,401195,401425,13,0,230,4
00017b1d,401055,401465,11,0,410,4
0002868b,401165,401525,10,1,360,4
00023e4d,401355,401725,15,1,370,4
0004296d,401535,401805,15,3,270,4
00034075,401405,401825,8,2,420,4
00049ee5,401415,401895,7,3,480,4
00032fb6,401505,401945,11,2,440,4
0002c607,135,475,8,1,340,15
0002c607,135,475,8,1,340,15
0001fa67,100355,100435,4,0,80,15
00021f95,100235,100475,5,1,240,15
000482d1,100265,100505,15,3,240,15
0003f4b3,100495,100605,3,2,110,15
0001715a,100325,100615,8,0,290,15
000177e4,100555,100655,4,0,100,15
0004351f,100275,100705,10,3,430,15
00029589,100525,100725,13,1,200,15
0001715a,100325,100735,8,0,410,15
0004a236,100245,100745,6,3,500,15
0003bda2,100435,100765,1,2,330,15
00015c88,100655,100855,5,0,200,15
0003bf69,100695,100915,4,2,220,15
0002a8e8,100565,101025,11,1,460,15
0002c607,135,475,8,1,340,15
0001fa67,100355,100435,4,0,80,15
00021f95,100235,100475,5,1,240,15
000482d1,100265,100505,15,3,240,15
0003f4b3,100495,100605,3,2,110,15
0001715a,100325,100615,8,0,290,15
000177e4,100555,100655,4,0,100,15
0004351f,100275,100705,10,3,430,15
00029589,100525,100725,13,1,200,15
0001715a,100325,100735,8,0,410,15
0004a236,100245,100745,6,3,500,15
0003bda2,100435,100765,1,2,330,15
00015c88,100655,100855,5,0,200,15
0003bf69,100695,100915,4,2,220,15
0002a8e8,100565,101025,11,1,460,15
00026f2d,200525,200665,3,1,140,15
0002202a,200365,200705,14,1,340,15
00035264,200435,200715,9,2,280,15
000188e1,200615,200835,6,0,220,15
000409d6,201005,201035,12,3,30,15
000312a5,200725,201045,6,2,320,15
00048776,200915,201115,1,3,200,15
0003ab5e,200885,201225,15,2,340,15
0004ea44,200685,201235,7,3,550,15
00026112,201105,201265,0,1,160,15
0003b096,200975,201265,10,2,290,15
0004ade4,201325,201455,2,3,130,15
00019974,201045,201525,11,0,480,15
000211aa,201185,201545,9,1,360,15
00043e2d,201225,201555,15,3,330,15
00042cee,201275,201595,0,3,320,15
0002b99d,201555,201605,1,1,50,15
00019974,201045,201735,11,0,690,15
00011597,201405,201835,12,0,430,15
0002e550,201275,201855,11,1,580,15
0004f474,201475,201865,11,3,390,15
00018670,201625,201875,6,0,250,15
00034c23,201705,202015,10,2,310,15
00021419,201695,202025,7,1,330,15
00014a8d,201765,202055,12,0,290,15
00017b09,201715,202095,9,0,380,15
00037228,201845,202125,5,2,280,15
0002c607,135,475,8,1,340,15
0001fa67,100355,100435,4,0,80,15
00021f95,100235,100475,5,1,240,15
000482d1,100265,100505,15,3,240,15
0003f4b3,100495,100605,3,2,110,15
0001715a,100325,100615,8,0,290,15
000177e4,100555,100655,4,0,100,15
0004351f,100275,100705,10,3,430,15
00029589,100525,100725,13,1,200,15
0001715a,100325,100735,8,0,410,15
0004a236,100245,100745,6,3,500,15
0003bda2,100435,100765,1,2,330,15
00015c88,100655,100855,5,0,200,15
0003bf69,100695,100915,4,2,220,15
0002a8e8,100565,101025,11,1,460,15
00026f2d,200525,200665,3,1,140,15
0002202a,200365,200705,14,1,340,15
00035264,200435,200715,9,2,280,15
000188e1,200615,200835,6,0,220,15
000409d6,201005,201035,12,3,30,15
000312a5,200725,201045,6,2,320,15
00048776,200915,201115,1,3,200,15
0003ab5e,200885,201225,15,2,340,15
0004ea44,200685,201235,7,3,550,15
00026112,201105,201265,0,1,160,15
0003b096,200975,201265,10,2,290,15
0004ade4,201325,201455,2,3,130,15
00019974,201045,201525,11,0,480,15
000211aa,201185,201545,9,1,360,15
00043e2d,201225,201555,15,3,330,15
00042cee,201275,201595,0,3,320,15
0002b99d,201555,201605,1,1,50,15
00019974,201045,201735,11,0,690,15
00011597,201405,201835,12,0,430,15
0002e550,201275,201855,11,1,580,15
0004f474,201475,201865,11,3,390,15
00018670,201625,201875,6,0,250,15
00034c23,201705,202015,10,2,310,15
00021419,201695,202025,7,1,330,15
00014a8d,201765,202055,12,0,290,15
00017b09,201715,202095,9,0,380,15
00037228,201845,202125,5,2,280,15
000159a9,300455,300615,3,0,160,15
0003eb34,300535,300725,3,2,190,15
0004aa43,300595,300905,9,3,310,15
00026007,300595,300975,10,1,380,15
0004fb61,300845,301045,1,3,200,15
0002a5a0,300705,301075,14,1,370,15
00038143,300765,301075,8,2,310,15
00040d51,300625,301135,6,3,510,15
0004b2b0,300875,301335,5,3,460,15
0003f45a,301045,301345,14,2,300,15
00024c33,300965,301385,10,1,420,15
0002c607,135,475,8,1,340,15
0001fa67,100355,100435,4,0,80,15
00021f95,100235,100475,5,1,240,15
000482d1,100265,100505,15,3,240,15
0003f4b3,100495,100605,3,2,110,15
0001715a,100325,100615,8,0,290,15
000177e4,100555,100655,4,0,100,15
0004351f,100275,100705,10,3,430,15
00029589,100525,100725,13,1,200,15
0001715a,100325,100735,8,0,410,15
0004a236,100245,100745,6,3,500,15
0003bda2,100435,100765,1,2,330,15
00015c88,100655,100855,5,0,200,15
0003bf69,100695,100915,4,2,220,15
0002a8e8,100565,101025,11,1,460,15
00026f2d,200525,200665,3,1,140,15
0002202a,200365,200705,14,1,340,15
00035264,200435,200715,9,2,280,15
000188e1,200615,200835,6,0,220,15
000409d6,201005,201035,12,3,30,15
000312a5,200725,201045,6,2,320,15
00048776,200915,201115,1,3,200,15
0003ab5e,200885,201225,15,2,340,15
0004ea44,200685,201235,7,3,550,15
00026112,201105,201265,0,1,160,15
0003b096,200975,201265,10,2,290,15
0004ade4,201325,201455,2,3,130,15
00019974,201045,201525,11,0,480,15
000211aa,201185,201545,9,1,360,15
00043e2d,201225,201555,15,3,330,15
00042cee,201275,201595,0,3,320,15
0002b99d,201555,201605,1,1,50,15
00019974,201045,201735,11,0,690,15
00011597,201405,201835,12,0,430,15
0002e550,201275,201855,11,1,580,15
0004f474,201475,201865,11,3,390,15
00018670,201625,201875,6,0,250,15
00034c23,201705,202015,10,2,310,15
00021419,201695,202025,7,1,330,15
00014a8d,201765,202055,12,0,290,15
00017b09,201715,202095,9,0,380,15
00037228,201845,202125,5,2,280,15
000159a9,300455,300615,3,0,160,15
0003eb34,300535,300725,3,2,190,15
0004aa43,300595,300905,9,3,310,15
00026007,300595,300975,10,1,380,15
0004fb61,300845,301045,1,3,200,15
0002a5a0,300705,301075,14,1,370,15
00038143,300765,301075,8,2,310,15
00040d51,300625,301135,6,3,510,15
0004b2b0,300875,301335,5,3,460,15
0003f45a,301045,301345,14,2,300,15
00024c33,300965,301385,10,1,420,15
000392d1,400585,400865,15,2,280,15
000300c3,400585,401015,8,2,430,15
0002d169,400745,401065,13,1,320,15
0002c7df,400785,401165,14,1,380,15
0004e37c,400665,401175,7,3,510,15
0002f4bc,400835,401285,15,1,450,15
0004d30a,400675,401295,9,3,620,15
000119a5,400915,401425,15,0,510,15
0001d698,400985,401505,14,0,520,15
0002009d,400965,401525,15,1,560,15
0004cdf5,125,305,14,3,180,6
0004cdf5,125,305,14,3,180,6
0003d1cf,100285,100385,2,2,100,6
00012323,100225,100405,3,0,180,6
000490b4,100225,100405,0,3,180,6
00015824,100465,100505,0,0,40,6
0001c719,100325,100615,8,0,290,6
0004d25a,100375,100645,4,3,270,6
00010bf2,100575,100655,4,0,80,6
00017f8c,100515,100725,12,0,210,6
00022990,100485,100805,8,1,320,6
00012a72,100645,100815,6,0,170,6
00041c7b,100385,100845,7,3,460,6
000102f0,100545,100925,3,0,380,6
000443af,100805,101025,4,3,220,6
00037cdf,100645,101075,6,2,430,6
0003e508,100725,101115,7,2,390,6
000417d6,100885,101225,11,3,340,6
00044600,100895,101345,11,3,450,6
0004cdf5,125,305,14,3,180,6
0003d1cf,100285,100385,2,2,100,6
00012323,100225,100405,3,0,180,6
000490b4,100225,100405,0,3,180,6
00015824,100465,100505,0,0,40,6
0001c719,100325,100615,8,0,290,6
0004d25a,100375,100645,4,3,270,6
00010bf2,100575,100655,4,0,80,6
00017f8c,100515,100725,12,0,210,6
00022990,100485,100805,8,1,320,6
00012a72,100645,100815,6,0,170,6
00041c7b,100385,100845,7,3,460,6
000102f0,100545,100925,3,0,380,6
000443af,100805,101025,4,3,220,6
00037cdf,100645,101075,6,2,430,6
0003e508,100725,101115,7,2,390,6
000417d6,100885,101225,11,3,340,6
00044600,100895,101345,11,3,450,6
000238dd,200365,200505,12,1,140,6
00015017,200445,200745,9,0,300,6
000168e3,200745,200795,4,0,50,6
000221d7,200765,200825,1,1,60,6
0002d8b3,200505,200865,3,1,360,6
0004f77e,200445,200875,9,3,430,6
0003040b,200585,200945,7,2,360,6
0004dd10,200775,201065,15,3,290,6
0003a643,200675,201085,9,2,410,6
0004f65e,200765,201105,1,3,340,6
0001ad8b,200755,201125,14,0,370,6
00025ae7,200805,201145,10,1,340,6
0004f5c7,201065,201165,12,3,100,6
0004cdf5,125,305,14,3,180,6
0003d1cf,100285,100385,2,2,100,6
00012323,100225,100405,3,0,180,6
000490b4,100225,100405,0,3,180,6
00015824,100465,100505,0,0,40,6
0001c719,100325,100615,8,0,290,6
0004d25a,100375,100645,4,3,270,6
00010bf2,100575,100655,4,0,80,6
00017f8c,100515,100725,12,0,210,6
00022990,100485,100805,8,1,320,6
00012a72,100645,100815,6,0,170,6
00041c7b,100385,100845,7,3,460,6
000102f0,100545,100925,3,0,380,6
000443af,100805,101025,4,3,220,6
00037cdf,100645,101075,6,2,430,6
0003e508,100725,101115,7,2,390,6
000417d6,100885,101225,11,3,340,6
00044600,100895,101345,11,3,450,6
000238dd,200365,200505,12,1,140,6
00015017,200445,200745,9,0,300,6
000168e3,200745,200795,4,0,50,6
000221d7,200765,200825,1,1,60,6
0002d8b3,200505,200865,3,1,360,6
0004f77e,200445,200875,9,3,430,6
0003040b,200585,200945,7,2,360,6
0004dd10,200775,201065,15,3,290,6
0003a643,200675,201085,9,2,410,6
0004f65e,200765,201105,1,3,340,6
0001ad8b,200755,201125,14,0,370,6
00025ae7,200805,201145,10,1,340,6
0004f5c7,201065,201165,12,3,100,6
000367f3,200885,201205,1,2,320,6
00021818,200955,201225,12,1,270,6
00023761,200835,201265,14,1,430,6
000284dd,201145,201305,4,1,160,6
00037b0c,201045,201355,15,2,310,6
00028364,201015,201365,14,1,350,6
0003d799,201155,201455,15,2,300,6
00027512,201175,201565,10,1,390,6
000425a3,201235,201605,15,3,370,6
0002ae72,201295,201665,12,1,370,6
000129d7,201125,201695,14,0,570,6
0003b79c,201345,201715,6,2,370,6
00021caa,201445,201785,12,1,340,6
0004b8d5,201435,201845,9,3,410,6
00021619,300465,300585,3,1,120,6
000246dd,300685,300775,0,1,90,6
00034d92,300545,300775,10,2,230,6
00042f6a,300555,300955,10,3,400,6
00035c30,300935,300985,2,2,50,6
0002b29f,300945,301025,1,1,80,6
0001b4f4,300755,301045,8,0,290,6
00036895,300625,301045,15,2,420,6
0003ee65,300755,301085,5,2,330,6
0004a38e,301095,301185,12,3,90,6
00020c8a,301015,301205,6,1,190,6
0002d773,300805,301245,7,1,440,6
00015f07,300885,301385,14,0,500,6
00026160,301135,301455,10,1,320,6
0004498b,301045,301515,7,3,470,6
0004cdf5,125,305,14,3,180,6
0003d1cf,100285,100385,2,2,100,6
00012323,100225,100405,3,0,180,6
000490b4,100225,100405,0,3,180,6
00015824,100465,100505,0,0,40,6
0001c719,100325,100615,8,0,290,6
0004d25a,100375,100645,4,3,270,6
00010bf2,100575,100655,4,0,80,6
00017f8c,100515,100725,12,0,210,6
00022990,100485,100805,8,1,320,6
00012a72,100645,100815,6,0,170,6
00041c7b,100385,100845,7,3,460,6
000102f0,100545,100925,3,0,380,6
000443af,100805,101025,4,3,220,6
00037cdf,100645,101075,6,2,430,6
0003e508,100725,101115,7,2,390,6
000417d6,100885,101225,11,3,340,6
00044600,100895,101345,11,3,450,6
000238dd,200365,200505,12,1,140,6
00015017,200445,200745,9,0,300,6
000168e3,200745,200795,4,0,50,6
000221d7,200765,200825,1,1,60,6
0002d8b3,200505,200865,3,1,360,6
0004f77e,200445,200875,9,3,430,6
0003040b,200585,200945,7,2,360,6
0004dd10,200775,201065,15,3,290,6
0003a643,200675,201085,9,2,410,6
0004f65e,200765,201105,1,3,340,6
0001ad8b,200755,201125,14,0,370,6
00025ae7,200805,201145,10,1,340,6
0004f5c7,201065,201165,12,3,100,6
000367f3,200885,201205,1,2,320,6
00021818,200955,201225,12,1,270,6
00023761,200835,201265,14,1,430,6
000284dd,201145,201305,4,1,160,6
00037b0c,201045,201355,15,2,310,6
00028364,201015,201365,14,1,350,6
0003d799,201155,201455,15,2,300,6
00027512,201175,201565,10,1,390,6
000425a3,201235,201605,15,3,370,6
0002ae72,201295,201665,12,1,370,6
000129d7,201125,201695,14,0,570,6
0003b79c,201345,201715,6,2,370,6
00021caa,201445,201785,12,1,340,6
0004b8d5,201435,201845,9,3,410,6
00021619,300465,300585,3,1,120,6
000246dd,300685,300775,0,1,90,6
00034d92,300545,300775,10,2,230,6
00042f6a,300555,300955,10,3,400,6
00035c30,300935,300985,2,2,50,6
0002b29f,300945,301025,1,1,80,6
0001b4f4,300755,301045,8,0,290,6
00036895,300625,301045,15,2,420,6
0003ee65,300755,301085,5,2,330,6
0004a38e,301095,301185,12,3,90,6
00020c8a,301015,301205,6,1,190,6
0002d773,300805,301245,7,1,440,6
00015f07,300885,301385,14,0,500,6
00026160,301135,301455,10,1,320,6
0004498b,301045,301515,7,3,470,6
00037d67,400496,400595,12,2,99,6
0004d6fe,400565,400835,4,3,270,6
0002943e,400595,400845,0,1,250,6
00015057,400805,400965,5,0,160,6
0004532a,400775,401065,1,3,290,6
0004c064,400705,401165,4,3,460,6
0004ba3e,400625,401265,6,3,640,6
0001b471,125,345,6,0,220,3
0001b471,125,345,6,0,220,3
00019457,100265,100525,8,0,260,3
0004eb86,100355,100695,10,3,340,3
00028725,100415,100705,5,1,290,3
0004444b,100345,100775,6,3,430,3
00046470,100505,100935,7,3,430,3
00024513,100565,100955,11,1,390,3
0001b471,125,345,6,0,220,3
00019457,100265,100525,8,0,260,3
0004eb86,100355,100695,10,3,340,3
00028725,100415,100705,5,1,290,3
0004444b,100345,100775,6,3,430,3
00046470,100505,100935,7,3,430,3
00024513,100565,100955,11,1,390,3
0001fe6d,200325,200625,14,0,300,3
00024e91,200385,200655,6,1,270,3
00029bc7,200645,200715,1,1,70,3
0004b531,200715,200895,0,3,180,3
000190bb,200605,200925,13,0,320,3
0003261e,200515,200965,14,2,450,3
0002f3db,200475,201015,14,1,540,3
00045402,201015,201065,3,3,50,3
00023880,200705,201075,7,1,370,3
0004adbb,201125,201195,3,3,70,3
00023afa,200805,201215,15,1,410,3
00029164,200945,201295,14,1,350,3
0002434a,200875,201335,7,1,460,3
0003cd25,201055,201345,14,2,290,3
00046711,200945,201395,7,3,450,3
0002327c,200975,201435,13,1,460,3
0002dbfa,201235,201475,6,1,240,3
0004b080,201155,201495,13,3,340,3
00024d5b,201135,201555,13,1,420,3
000430d7,200975,201645,7,3,670,3
0001b471,125,345,6,0,220,3
00019457,100265,100525,8,0,260,3
0004eb86,100355,100695,10,3,340,3
00028725,100415,100705,5,1,290,3
0004444b,100345,100775,6,3,430,3
00046470,100505,100935,7,3,430,3
00024513,100565,100955,11,1,390,3
0001fe6d,200325,200625,14,0,300,3
00024e91,200385,200655,6,1,270,3
00029bc7,200645,200715,1,1,70,3
0004b531,200715,200895,0,3,180,3
000190bb,200605,200925,13,0,320,3
0003261e,200515,200965,14,2,450,3
0002f3db,200475,201015,14,1,540,3
00045402,201015,201065,3,3,50,3
00023880,200705,201075,7,1,370,3
0004adbb,201125,201195,3,3,70,3
00023afa,200805,201215,15,1,410,3
00029164,200945,201295,14,1,350,3
0002434a,200875,201335,7,1,460,3
0003cd25,201055,201345,14,2,290,3
00046711,200945,201395,7,3,450,3
0002327c,200975,201435,13,1,460,3
0002dbfa,201235,201475,6,1,240,3
0004b080,201155,201495,13,3,340,3
00024d5b,201135,201555,13,1,420,3
000430d7,200975,201645,7,3,670,3
0002dbb3,300435,300475,1,1,40,3
00044a76,300485,300665,14,3,180,3
000254c1,300565,300865,6,1,300,3
0004c809,300445,300895,7,3,450,3
00031713,300635,300945,10,2,310,3
00031c63,300705,301085,6,2,380,3
0004fa75,300855,301115,15,3,260,3
000215aa,300905,301145,0,1,240,3
0004f8e7,300905,301155,5,3,250,3
0002556a,300815,301205,10,1,390,3
00033094,300765,301225,8,2,460,3
00022e56,301025,301265,12,1,240,3
000311a2,300985,301265,1,2,280,3
0001ec6a,300905,301325,9,0,420,3
0002cda1,300885,301415,10,1,530,3
0002cc35,300985,301455,9,1,470,3
0001b471,125,345,6,0,220,3
00019457,100265,100525,8,0,260,3
0004eb86,100355,100695,10,3,340,3
00028725,100415,100705,5,1,290,3
0004444b,100345,100775,6,3,430,3
00046470,100505,100935,7,3,430,3
00024513,100565,100955,11,1,390,3
0001fe6d,200325,200625,14,0,300,3
00024e91,200385,200655,6,1,270,3
00029bc7,200645,200715,1,1,70,3
0004b531,200715,200895,0,3,180,3
000190bb,200605,200925,13,0,320,3
0003261e,200515,200965,14,2,450,3
0002f3db,200475,201015,14,1,540,3
00045402,201015,201065,3,3,50,3
00023880,200705,201075,7,1,370,3
0004adbb,201125,201195,3,3,70,3
00023afa,200805,201215,15,1,410,3
00029164,200945,201295,14,1,350,3
0002434a,200875,201335,7,1,460,3
0003cd25,201055,201345,14,2,290,3
00046711,200945,201395,7,3,450,3
0002327c,200975,201435,13,1,460,3
0002dbfa,201235,201475,6,1,240,3
0004b080,201155,201495,13,3,340,3
00024d5b,201135,201555,13,1,420,3
000430d7,200975,201645,7,3,670,3
0002dbb3,300435,300475,1,1,40,3
00044a76,300485,300665,14,3,180,3
000254c1,300565,300865,6,1,300,3
0004c809,300445,300895,7,3,450,3
00031713,300635,300945,10,2,310,3
00031c63,300705,301085,6,2,380,3
0004fa75,300855,301115,15,3,260,3
000215aa,300905,301145,0,1,240,3
0004f8e7,300905,301155,5,3,250,3
0002556a,300815,301205,10,1,390,3
00033094,300765,301225,8,2,460,3
00022e56,301025,301265,12,1,240,3
000311a2,300985,301265,1,2,280,3
0001ec6a,300905,301325,9,0,420,3
0002cda1,300885,301415,10,1,530,3
0002cc35,300985,301455,9,1,470,3
0003affe,400545,400645,12,2,100,3
0003bf7c,400545,400805,5,2,260,3
00025dcf,400605,400865,5,1,260,3
0003b834,400595,400865,15,2,270,3
0002ec3c,400595,400905,6,1,310,3
0004f3a1,400595,400935,10,3,340,3
0002680e,400665,400985,9,1,320,3
0002c460,400765,401035,8,1,270,3
0002341c,400665,401115,14,1,450,3
0003a6a1,400955,401175,0,2,220,3
00039330,400875,401235,11,2,360,3
0003baab,400715,401275,7,2,560,3
00020412,401215,401355,5,1,140,3
00030e92,400805,401375,6,2,570,3
00041aba,401125,401465,10,3,340,3
00032d3b,401015,401475,10,2,460,3
00012296,401185,401525,3,0,340,3
000481f0,400975,401605,8,3,630,3
0003e2f4,401295,401615,14,2,320,3
0001de50,401095,401645,14,0,550,3
00029609,155,295,12,1,140,5
00029609,155,295,12,1,140,5
00019daf,100205,100525,10,0,320,5
0004a001,100315,100545,15,3,230,5
00019daf,100205,100645,10,0,440,5
0001ace0,100355,100685,7,0,330,5
00026365,100435,100725,14,1,290,5
00029609,155,295,12,1,140,5
00019daf,100205,100525,10,0,320,5
0004a001,100315,100545,15,3,230,5
00019daf,100205,100645,10,0,440,5
0001ace0,100355,100685,7,0,330,5
00026365,100435,100725,14,1,290,5
0001e3db,200305,200385,1,0,80,5
0004dd38,200296,200415,2,3,119,5
0004d258,200455,200545,13,3,90,5
00043d7a,200395,200585,2,3,190,5
00048170,200345,200685,1,3,340,5
0003cccd,200515,200755,5,2,240,5
000368c9,200605,200855,1,2,250,5
00024dcb,200685,201035,9,1,350,5
00033df8,200765,201035,15,2,270,5
00040e61,200925,201105,13,3,180,5
0004aaa4,200515,201145,9,3,630,5
0003162c,201045,201175,1,2,130,5
0004242e,200715,201225,9,3,510,5
00048e3f,200995,201265,1,3,270,5
0003162c,201045,201275,1,2,230,5
0001f57e,200995,201285,12,0,290,5
0003edab,200835,201375,9,2,540,5
00013203,201075,201405,1,0,330,5
0002c0ed,201055,201425,9,1,370,5
00029609,155,295,12,1,140,5
00019daf,100205,100525,10,0,320,5
0004a001,100315,100545,15,3,230,5
00019daf,100205,100645,10,0,440,5
0001ace0,100355,100685,7,0,330,5
00026365,100435,100725,14,1,290,5
0001e3db,200305,200385,1,0,80,5
0004dd38,200296,200415,2,3,119,5
0004d258,200455,200545,13,3,90,5
00043d7a,200395,200585,2,3,190,5
00048170,200345,200685,1,3,340,5
0003cccd,200515,200755,5,2,240,5
000368c9,200605,200855,1,2,250,5
00024dcb,200685,201035,9,1,350,5
00033df8,200765,201035,15,2,270,5
00040e61,200925,201105,13,3,180,5
0004aaa4,200515,201145,9,3,630,5
0003162c,201045,201175,1,2,130,5
0004242e,200715,201225,9,3,510,5
00048e3f,200995,201265,1,3,270,5
0003162c,201045,201275,1,2,230,5
0001f57e,200995,201285,12,0,290,5
0003edab,200835,201375,9,2,540,5
00013203,201075,201405,1,0,330,5
0002c0ed,201055,201425,9,1,370,5
00023323,300425,300605,4,1,180,5
00039fdb,300515,300825,5,2,310,5
00030025,300645,300905,10,2,260,5
000352d5,300725,300945,1,2,220,5
00049afc,300645,300975,15,3,330,5
0001d034,300545,300995,15,0,450,5
000379ad,300845,301005,12,2,160,5
00010c1c,300775,301035,13,0,260,5
000360d8,300555,301045,5,2,490,5
00037a08,300855,301085,1,2,230,5
0003d705,300525,301185,5,2,660,5
00016a66,301035,301195,0,0,160,5
0004fe37,301125,301255,2,3,130,5
000173aa,300945,301305,14,0,360,5
00036ee6,300995,301325,0,2,330,5
00011310,301065,301385,3,0,320,5
0002304e,301075,301415,14,1,340,5
00021c5b,301295,301535,9,1,240,5
0003db7e,301225,301565,15,2,340,5
0001285a,301175,301585,3,0,410,5
000161d2,301275,301645,10,0,370,5
00029609,155,295,12,1,140,5
00019daf,100205,100525,10,0,320,5
0004a001,100315,100545,15,3,230,5
00019daf,100205,100645,10,0,440,5
0001ace0,100355,100685,7,0,330,5
00026365,100435,100725,14,1,290,5
0001e3db,200305,200385,1,0,80,5
0004dd38,200296,200415,2,3,119,5
0004d258,200455,200545,13,3,90,5
00043d7a,200395,200585,2,3,190,5
00048170,200345,200685,1,3,340,5
0003cccd,200515,200755,5,2,240,5
000368c9,200605,200855,1,2,250,5
00024dcb,200685,201035,9,1,350,5
00033df8,200765,201035,15,2,270,5
00040e61,200925,201105,13,3,180,5
0004aaa4,200515,201145,9,3,630,5
0003162c,201045,201175,1,2,130,5
0004242e,200715,201225,9,3,510,5
00048e3f,200995,201265,1,3,270,5
0003162c,201045,201275,1,2,230,5
0001f57e,200995,201285,12,0,290,5
0003edab,200835,201375,9,2,540,5
00013203,201075,201405,1,0,330,5
0002c0ed,201055,201425,9,1,370,5
00023323,300425,300605,4,1,180,5
00039fdb,300515,300825,5,2,310,5
00030025,300645,300905,10,2,260,5
000352d5,300725,300945,1,2,220,5
00049afc,300645,300975,15,3,330,5
0001d034,300545,300995,15,0,450,5
000379ad,300845,301005,12,2,160,5
00010c1c,300775,301035,13,0,260,5
000360d8,300555,301045,5,2,490,5
00037a08,300855,301085,1,2,230,5
0003d705,300525,301185,5,2,660,5
00016a66,301035,301195,0,0,160,5
0004fe37,301125,301255,2,3,130,5
000173aa,300945,301305,14,0,360,5
00036ee6,300995,301325,0,2,330,5
00011310,301065,301385,3,0,320,5
0002304e,301075,301415,14,1,340,5
00021c5b,301295,301535,9,1,240,5
0003db7e,301225,301565,15,2,340,5
0001285a,301175,301585,3,0,410,5
000161d2,301275,301645,10,0,370,5
000274eb,400505,400645,12,1,140,5
0004c5d5,400645,400765,12,3,120,5
0001cdc0,400825,400905,4,0,80,5
00024b03,400565,400925,8,1,360,5
000383cf,400795,400965,13,2,170,5
00020c6a,400705,401005,5,1,300,5
0001f105,400665,401045,3,0,380,5
00023301,400955,401105,2,1,150,5
0003b0a5,400785,401125,6,2,340,5
0001ac36,400885,401135,8,0,250,5
000276a6,400705,401145,10,1,440,5
00033f49,400885,401215,11,2,330,5
000258ba,400885,401245,5,1,360,5
00010696,135,235,4,0,100,11
00010696,135,235,4,0,100,11
0001a914,100255,100495,13,0,240,11
0002b371,100385,100605,13,1,220,11
0003fd8e,100295,100715,8,2,420,11
0002b371,100385,100725,13,1,340,11
00020ce1,100435,100765,8,1,330,11
00017e78,100565,100875,7,0,310,11
00010671,100655,101005,8,0,350,11
00024b0b,100715,101005,9,1,290,11
0002fcf7,101015,101085,2,1,70,11
0002fcf7,101015,101205,2,1,190,11
0001a2c2,101075,101255,1,0,180,11
0002b163,100785,101265,8,1,480,11
00030d3b,100965,101295,8,2,330,11
0002bd7c,100815,101325,11,1,510,11
00040548,101165,101445,0,3,280,11
00031ffc,101085,101495,11,2,410,11
0003366f,101265,101575,6,2,310,11
00038e82,100905,101615,7,2,710,11
00023926,101115,101665,11,1,550,11
0003ff7f,101235,101715,5,2,480,11
00010696,135,235,4,0,100,11
0001a914,100255,100495,13,0,240,11
0002b371,100385,100605,13,1,220,11
0003fd8e,100295,100715,8,2,420,11
0002b371,100385,100725,13,1,340,11
00020ce1,100435,100765,8,1,330,11
00017e78,100565,100875,7,0,310,11
00010671,100655,101005,8,0,350,11
00024b0b,100715,101005,9,1,290,11
0002fcf7,101015,101085,2,1,70,11
0002fcf7,101015,101205,2,1,190,11
0001a2c2,101075,101255,1,0,180,11
0002b163,100785,101265,8,1,480,11
00030d3b,100965,101295,8,2,330,11
0002bd7c,100815,101325,11,1,510,11
00040548,101165,101445,0,3,280,11
00031ffc,101085,101495,11,2,410,11
0003366f,101265,101575,6,2,310,11
00038e82,100905,101615,7,2,710,11
00023926,101115,101665,11,1,550,11
0003ff7f,101235,101715,5,2,480,11
00025a8e,200345,200425,2,1,80,11
00019d76,200385,200575,3,0,190,11
00027553,200345,200715,11,1,370,11
00040acf,200565,200765,1,3,200,11
0002b255,200515,200845,9,1,330,11
000460f2,200465,200855,7,3,390,11
0004c5f4,200725,200985,14,3,260,11
000126e3,200835,201055,8,0,220,11
00037dfe,200785,201105,6,2,320,11
00029ebe,200635,201235,15,1,600,11
0002e9c1,200885,201295,6,1,410,11
000487ff,200945,201295,10,3,350,11
0002540f,201145,201335,3,1,190,11
00024114,201265,201435,1,1,170,11
0004bf55,201325,201435,2,3,110,11
00042e55,201395,201495,12,3,100,11
00021304,201405,201535,4,1,130,11
0001fe93,201225,201555,3,0,330,11
0004a78a,200965,201555,8,3,590,11
0002bcf9,201325,201595,9,1,270,11
0002a7ad,201355,201635,5,1,280,11
0002f12f,201285,201755,8,1,470,11
0001a387,201055,201765,15,0,710,11
00010696,135,235,4,0,100,11
0001a914,100255,100495,13,0,240,11
0002b371,100385,100605,13,1,220,11
0003fd8e,100295,100715,8,2,420,11
0002b371,100385,100725,13,1,340,11
00020ce1,100435,100765,8,1,330,11
00017e78,100565,100875,7,0,310,11
00010671,100655,101005,8,0,350,11
00024b0b,100715,101005,9,1,290,11
0002fcf7,101015,101085,2,1,70,11
0002fcf7,101015,101205,2,1,190,11
0001a2c2,101075,101255,1,0,180,11
0002b163,100785,101265,8,1,480,11
00030d3b,100965,101295,8,2,330,11
0002bd7c,100815,101325,11,1,510,11
00040548,101165,101445,0,3,280,11
00031ffc,101085,101495,11,2,410,11
0003366f,101265,101575,6,2,310,11
00038e82,100905,101615,7,2,710,11
00023926,101115,101665,11,1,550,11
0003ff7f,101235,101715,5,2,480,11
00025a8e,200345,200425,2,1,80,11
00019d76,200385,200575,3,0,190,11
00027553,200345,200715,11,1,370,11
00040acf,200565,200765,1,3,200,11
0002b255,200515,200845,9,1,330,11
000460f2,200465,200855,7,3,390,11
0004c5f4,200725,200985,14,3,260,11
000126e3,200835,201055,8,0,220,11
00037dfe,200785,201105,6,2,320,11
00029ebe,200635,201235,15,1,600,11
0002e9c1,200885,201295,6,1,410,11
000487ff,200945,201295,10,3,350,11
0002540f,201145,201335,3,1,190,11
00024114,201265,201435,1,1,170,11
0004bf55,201325,201435,2,3,110,11
00042e55,201395,201495,12,3,100,11
00021304,201405,201535,4,1,130,11
0001fe93,201225,201555,3,0,330,11
0004a78a,200965,201555,8,3,590,11
0002bcf9,201325,201595,9,1,270,11
0002a7ad,201355,201635,5,1,280,11
0002f12f,201285,201755,8,1,470,11
0001a387,201055,201765,15,0,710,11
00025d3f,300555,300635,2,1,80,11
000390ec,300535,300755,14,2,220,11
00035537,300475,300795,5,2,320,11
0003bb7a,300435,300835,9,2,400,11
0004fa78,300665,300845,13,3,180,11
0003509a,300475,300915,9,2,440,11
0004c1d3,300615,300985,1,3,370,11
00010696,135,235,4,0,100,11
0001a914,100255,100495,13,0,240,11
0002b371,100385,100605,13,1,220,11
0003fd8e,100295,100715,8,2,420,11
0002b371,100385,100725,13,1,340,11
00020ce1,100435,100765,8,1,330,11
00017e78,100565,100875,7,0,310,11
00010671,100655,101005,8,0,350,11
00024b0b,100715,101005,9,1,290,11
0002fcf7,101015,101085,2,1,70,11
0002fcf7,101015,101205,2,1,190,11
0001a2c2,101075,101255,1,0,180,11
0002b163,100785,101265,8,1,480,11
00030d3b,100965,101295,8,2,330,11
0002bd7c,100815,101325,11,1,510,11
00040548,101165,101445,0,3,280,11
00031ffc,101085,101495,11,2,410,11
0003366f,101265,101575,6,2,310,11
00038e82,100905,101615,7,2,710,11
00023926,101115,101665,11,1,550,11
0003ff7f,101235,101715,5,2,480,11
00025a8e,200345,200425,2,1,80,11
00019d76,200385,200575,3,0,190,11
00027553,200345,200715,11,1,370,11
00040acf,200565,200765,1,3,200,11
0002b255,200515,200845,9,1,330,11
000460f2,200465,200855,7,3,390,11
0004c5f4,200725,200985,14,3,260,11
000126e3,200835,201055,8,0,220,11
00037dfe,200785,201105,6,2,320,11
00029ebe,200635,201235,15,1,600,11
0002e9c1,200885,201295,6,1,410,11
000487ff,200945,201295,10,3,350,11
0002540f,201145,201335,3,1,190,11
00024114,201265,201435,1,1,170,11
0004bf55,201325,201435,2,3,110,11
00042e55,201395,201495,12,3,100,11
00021304,201405,201535,4,1,130,11
0001fe93,201225,201555,3,0,330,11
0004a78a,200965,201555,8,3,590,11
0002bcf9,201325,201595,9,1,270,11
0002a7ad,201355,201635,5,1,280,11
0002f12f,201285,201755,8,1,470,11
0001a387,201055,201765,15,0,710,11
00025d3f,300555,300635,2,1,80,11
000390ec,300535,300755,14,2,220,11
00035537,300475,300795,5,2,320,11
0003bb7a,300435,300835,9,2,400,11
0004fa78,300665,300845,13,3,180,11
0003509a,300475,300915,9,2,440,11
0004c1d3,300615,300985,1,3,370,11
00025fa8,400625,400835,14,1,210,11
000395b9,400595,400885,10,2,290,11
0001487b,400815,400925,5,0,110,11
0002a12a,400745,400935,12,1,190,11
0004c500,400525,400965,7,3,440,11
00025441,400655,400975,8,1,320,11
00026ce2,400715,401015,4,1,300,11
0003c807,400685,401035,10,2,350,11
00034777,401085,401185,3,2,100,11
00034561,400775,401225,8,2,450,11
00016312,400995,401335,7,0,340,11
00022f8f,400905,401335,15,1,430,11
00025300,400905,401455,7,1,550,11
0001f90b,135,295,3,0,160,10
0001f90b,135,295,3,0,160,10
0001d135,100205,100385,12,0,180,10
0003e791,100375,100415,2,2,40,10
00044265,100305,100465,14,3,160,10
0002751c,100245,100545,3,1,300,10
000387fa,100485,100575,2,2,90,10
0001ddba,100515,100655,5,0,140,10
0004cff1,100405,100695,0,3,290,10
000148d0,100675,100725,4,0,50,10
000447f6,100585,100825,15,3,240,10
00011ee8,100615,100985,11,0,370,10
0001f90b,135,295,3,0,160,10
0001d135,100205,100385,12,0,180,10
0003e791,100375,100415,2,2,40,10
00044265,100305,100465,14,3,160,10
0002751c,100245,100545,3,1,300,10
000387fa,100485,100575,2,2,90,10
0001ddba,100515,100655,5,0,140,10
0004cff1,100405,100695,0,3,290,10
000148d0,100675,100725,4,0,50,10
000447f6,100585,100825,15,3,240,10
00011ee8,100615,100985,11,0,370,10
000153f9,200335,200555,8,0,220,10
00041ffc,200296,200835,7,3,539,10
0002ae1c,200405,200865,7,1,460,10
0001f90b,135,295,3,0,160,10
0001d135,100205,100385,12,0,180,10
0003e791,100375,100415,2,2,40,10
00044265,100305,100465,14,3,160,10
0002751c,100245,100545,3,1,300,10
000387fa,100485,100575,2,2,90,10
0001ddba,100515,100655,5,0,140,10
0004cff1,100405,100695,0,3,290,10
000148d0,100675,100725,4,0,50,10
000447f6,100585,100825,15,3,240,10
00011ee8,100615,100985,11,0,370,10
000153f9,200335,200555,8,0,220,10
00041ffc,200296,200835,7,3,539,10
0002ae1c,200405,200865,7,1,460,10
00013a76,300435,300595,5,0,160,10
000360d4,300435,300655,14,2,220,10
000375e4,300685,300835,12,2,150,10
00024493,300735,300865,2,1,130,10
00010448,300595,300925,9,0,330,10
0004fbe0,300505,300925,5,3,420,10
00029435,300695,301045,13,1,350,10
00045211,300765,301075,6,3,310,10
0003837c,300805,301135,9,2,330,10
000369c9,300885,301195,10,2,310,10
00010090,300755,301215,10,0,460,10
0002189e,301095,301285,5,1,190,10
0004679d,301025,301285,11,3,260,10
00038e9b,300975,301315,10,2,340,10
00030753,301255,301375,2,2,120,10
00029fc5,301165,301385,6,1,220,10
00021fb2,301085,301425,12,1,340,10
0004b8d7,301355,301425,3,3,70,10
00025140,300995,301465,10,1,470,10
0004d0f1,301095,301685,7,3,590,10
00038985,301515,301725,12,2,210,10
00028443,301465,301735,6,1,270,10
00011c3c,301465,301765,3,0,300,10
0003c389,301295,301825,11,2,530,10
00032af3,301405,301865,7,2,460,10
0004fc85,301385,301955,7,3,570,10
00028045,301565,302055,11,1,490,10
00048c7d,301585,302135,6,3,550,10
0001f90b,135,295,3,0,160,10
0001d135,100205,100385,12,0,180,10
0003e791,100375,100415,2,2,40,10
00044265,100305,100465,14,3,160,10
0002751c,100245,100545,3,1,300,10
000387fa,100485,100575,2,2,90,10
0001ddba,100515,100655,5,0,140,10
0004cff1,100405,100695,0,3,290,10
000148d0,100675,100725,4,0,50,10
000447f6,100585,100825,15,3,240,10
00011ee8,100615,100985,11,0,370,10
000153f9,200335,200555,8,0,220,10
00041ffc,200296,200835,7,3,539,10
0002ae1c,200405,200865,7,1,460,10
00013a76,300435,300595,5,0,160,10
000360d4,300435,300655,14,2,220,10
000375e4,300685,300835,12,2,150,10
00024493,300735,300865,2,1,130,10
00010448,300595,300925,9,0,330,10
0004fbe0,300505,300925,5,3,420,10
00029435,300695,301045,13,1,350,10
00045211,300765,301075,6,3,310,10
0003837c,300805,301135,9,2,330,10
000369c9,300885,301195,10,2,310,10
00010090,300755,301215,10,0,460,10
0002189e,301095,301285,5,1,190,10
0004679d,301025,301285,11,3,260,10
00038e9b,300975,301315,10,2,340,10
00030753,301255,301375,2,2,120,10
00029fc5,301165,301385,6,1,220,10
00021fb2,301085,301425,12,1,340,10
0004b8d7,301355,301425,3,3,70,10
00025140,300995,301465,10,1,470,10
0004d0f1,301095,301685,7,3,590,10
00038985,301515,301725,12,2,210,10
00028443,301465,301735,6,1,270,10
00011c3c,301465,301765,3,0,300,10
0003c389,301295,301825,11,2,530,10
00032af3,301405,301865,7,2,460,10
0004fc85,301385,301955,7,3,570,10
00028045,301565,302055,11,1,490,10
00048c7d,301585,302135,6,3,550,10
000185eb,400565,400685,2,0,120,10
0001b88d,400755,400985,2,0,230,10
00020cb4,400575,401035,11,1,460,10
000451aa,400805,401065,4,3,260,10
00019f64,400635,401085,10,0,450,10
0003c05b,400675,401095,11,2,420,10
00011312,400755,401125,13,0,370,10
000110c7,400855,401205,12,0,350,10
